Code,Municipality,People,Males,Females,Asymmetry,State Code
09012,Tlalpan,650567,312139,338428,-0.04040936598382642,09
09013,Xochimilco,415007,205305,209702,-0.010595002012014255,09
09008,La Magdalena Contreras,239086,114492,124594,-0.04225257857005429,09
09002,Azcapotzalco,414711,196053,218658,-0.05450783798838227,09
09014,Benito Juárez,385439,176410,209029,-0.08462817722129831,09
09015,Cuauhtémoc,531831,251725,280106,-0.05336469667996036,09
09010,Álvaro Obregón,727034,346041,380993,-0.048074780546714456,09
09005,Gustavo A. Madero,1185772,571233,614539,-0.03652135486417288,09
09004,Cuajimalpa de Morelos,186391,88642,97749,-0.048859655240864636,09
09016,Miguel Hidalgo,372889,172667,200222,-0.07389598513230479,09
09006,Iztacalco,384326,182534,201792,-0.0501085016366314,09
09003,Coyoacán,620416,292491,327925,-0.05711329172684135,09
09017,Venustiano Carranza,430978,203651,227327,-0.05493551875037705,09
09011,Tláhuac,360265,175210,185055,-0.027327106435540503,09
09007,Iztapalapa,1815786,880998,934788,-0.029623534931979868,09
09009,Milpa Alta,130582,64192,66390,-0.016832335237628462,09
12006,Apaxtla,12389,5949,6440,-0.03963193155218339,12
12017,Cocula,14707,7060,7647,-0.0399129666145373,12
12026,Cuetzala del Progreso,9166,4443,4723,-0.030547676194632337,12
12028,Chilapa de Álvarez,120790,57940,62850,-0.0406490603526782,12
12029,Chilpancingo de los Bravo,241717,115443,126274,-0.044808598485005194,12
12031,General Canuto A. Neri,6301,3042,3259,-0.034438977940009524,12
12032,General Heliodoro Castillo,36586,18348,18238,0.003006614552014432,12
12034,Huitzuco de los Figueroa,37364,17935,19429,-0.0399850123113157,12
12039,Juan R. Escudero,24364,11949,12415,-0.019126580200295517,12
12040,Leonardo Bravo,24720,12231,12489,-0.010436893203883494,12
12042,Mártir de Cuilapan,17702,8504,9198,-0.03920460964862727,12
12044,Mochitlán,11376,5617,5759,-0.012482419127988748,12
12051,Quechultenango,34728,16855,17873,-0.029313522229900944,12
12053,San Marcos,48501,23896,24605,-0.014618255293705284,12
12056,Tecoanapa,44079,21733,22346,-0.013906849066448877,12
12058,Teloloapan,53769,25442,28327,-0.053655452026260486,12
12059,Tepecoacuilco de Trujano,30470,14612,15858,-0.040892681325894326,12
12061,Tixtla de Guerrero,40058,19369,20689,-0.03295221928204104,12
12074,Zitlala,22587,10750,11837,-0.04812502767078408,12
12075,Eduardo Neri,46158,22634,23524,-0.019281597989514277,12
12035,Iguala de la Independencia,140363,67611,72752,-0.03662646138939749,12
12021,Coyuca de Benítez,73460,35960,37500,-0.020963789817587803,12
12005,Alpoyeca,6637,3114,3523,-0.06162422781377128,12
12008,Atenango del Río,8390,4015,4375,-0.04290822407628129,12
12009,Atlamajalcingo del Monte,5706,2728,2978,-0.043813529617946025,12
12010,Atlixtac,26341,12674,13667,-0.03769788542576212,12
12012,Ayutla de los Libres,62690,30706,31984,-0.020386026479502314,12
12013,Azoyú,14429,7102,7327,-0.015593596229814956,12
12018,Copala,13636,6717,6919,-0.014813728366089763,12
12019,Copalillo,14456,6860,7596,-0.0509131156613171,12
12020,Copanatoyac,18855,9049,9806,-0.04014850172368072,12
12024,Cualác,7007,3344,3663,-0.04552590266875981,12
12025,Cuautepec,15115,7554,7561,-0.00046311610982467747,12
12030,Florencio Villarreal,20175,9967,10208,-0.011945477075588599,12
12033,Huamuxtitlán,14393,6823,7570,-0.05190022927812131,12
12036,Igualapa,10815,5290,5525,-0.021729079981507166,12
12041,Malinaltepec,29599,14110,15489,-0.046589411804452856,12
12045,Olinalá,24723,11878,12845,-0.03911337620838895,12
12046,Ometepec,61306,29891,31415,-0.0248589045117933,12
12052,San Luis Acatlán,42360,20867,21493,-0.0147780925401322,12
12063,Tlacoapa,9967,4734,5233,-0.050065215210193637,12
12066,Tlapa de Comonfort,81419,38983,42436,-0.04241024822215945,12
12069,Xalpatláhuac,12240,5690,6550,-0.07026143790849673,12
12070,Xochihuehuetlán,7079,3289,3790,-0.07077270800960588,12
12071,Xochistlahuaca,28089,13646,14443,-0.028374096621453238,12
12072,Zapotitlán Tablas,10516,5037,5479,-0.04203119056675542,12
12076,Acatepec,32792,16070,16722,-0.01988289826787021,12
12077,Marquelia,12912,6396,6516,-0.00929368029739777,12
12079,José Joaquin de Herrera,15678,7743,7935,-0.012246460007654038,12
12080,Juchitán,7166,3605,3561,0.006140106056377337,12
12081,Iliatenco,10522,5075,5447,-0.03535449534309067,12
12023,Cuajinicuilapa,25922,12944,12978,-0.001311627189260088,12
12062,Tlacoachistlahuaca,21306,10191,11115,-0.043368065333708815,12
12065,Tlalixtaquilla de Maldonado,7096,3396,3700,-0.04284103720405862,12
12004,Alcozauca de Guerrero,18971,8917,10054,-0.05993358283696168,12
12043,Metlatónoc,18976,9014,9962,-0.04995784148397976,12
12078,Cochoapa el Grande,18778,8945,9833,-0.04728938119075514,12
12002,Ahuacuotzingo,25027,11748,13279,-0.06117393215327446,12
12048,Petatlán,44979,22397,22582,-0.004113030525356278,12
12003,Ajuchitlán del Progreso,38203,18342,19861,-0.039761275292516295,12
12007,Arcelia,32181,15644,16537,-0.027749293061123025,12
12011,Atoyac de Álvarez,61316,30113,31203,-0.017776762998238632,12
12014,Benito Juárez,15019,7363,7656,-0.01950862241161196,12
12016,Coahuayutla de José María Izazaga,13025,6632,6393,0.01834932821497121,12
12027,Cutzamala de Pinzón,21388,10528,10860,-0.01552272302225547,12
12054,San Miguel Totolapan,28009,13755,14254,-0.017815702095754934,12
12057,Técpan de Galeana,62071,30871,31200,-0.005300381820818096,12
12064,Tlalchapa,11495,5737,5758,-0.0018268812527185733,12
12067,Tlapehuala,21819,10558,11261,-0.03221962509739218,12
12022,Coyuca de Catalán,42069,21849,20220,0.03872209940811524,12
12073,Zirándaro,18813,9799,9014,0.041726465741774306,12
12068,La Unión de Isidoro Montes de Oca,25712,13087,12625,0.01796826384567517,12
12037,Ixcateopan de Cuauhtémoc,6603,3148,3455,-0.04649401787066485,12
12047,Pedro Ascencio Alquisiras,6978,3215,3763,-0.07853253081112066,12
12049,Pilcaya,11558,5597,5961,-0.031493337947741826,12
12060,Tetipac,13128,6356,6772,-0.031687995124923825,12
12055,Taxco de Alarcón,104053,50432,53621,-0.030647842926201072,12
12015,Buenavista de Cuéllar,12688,6192,6496,-0.02395964691046658,12
12050,Pungarabato,37035,17921,19114,-0.03221277170244363,12
12038,Zihuatanejo de Azueta,118211,58314,59897,-0.01339130876145198,12
12001,Acapulco de Juárez,789971,382276,407695,-0.032177130552893715,12
15082,Tejupilco,71077,34411,36666,-0.03172615614052366,15
15104,Tlalnepantla de Baz,664225,321747,342478,-0.031210809590123827,15
15075,San Martín de las Pirámides,24851,12278,12573,-0.011870749668021407,15
15065,Otumba,34232,17330,16902,0.01250292124328114,15
15049,Joquicingo,12840,6201,6639,-0.03411214953271028,15
15004,Almoloya de Alquisiras,14856,7091,7765,-0.04536887452880991,15
15088,Tenancingo,90946,44239,46707,-0.02713698238515163,15
15056,Morelos,28426,13617,14809,-0.04193344121578836,15
15125,Tonanitla,10216,5058,5158,-0.009788566953797965,15
15124,San José del Rincón,91345,45084,46261,-0.012885215392194428,15
15123,Luvianos,27781,13719,14062,-0.012346567798135416,15
15122,Valle de Chalco Solidaridad,357645,175772,181873,-0.017058815305680215,15
15121,Cuautitlán Izcalli,511675,248552,263123,-0.028477060634191625,15
15120,Zumpango,159647,78608,81039,-0.015227345330635715,15
15119,Zumpahuacán,16365,7780,8585,-0.04919034524900703,15
15118,Zinacantepec,167759,82109,85650,-0.021107660393779173,15
15117,Zacualpan,15121,7217,7904,-0.04543350307519344,15
15116,Zacazonapan,4051,2033,2018,0.00370278943470748,15
15115,Xonacatlán,46331,22871,23460,-0.01271287043232393,15
15114,Villa Victoria,94369,46657,47712,-0.011179518697877481,15
15113,Villa Guerrero,59991,29293,30698,-0.02342017969362071,15
15112,Villa del Carbón,44881,22433,22448,-0.00033421715202424187,15
15111,Villa de Allende,47709,23413,24296,-0.01850803831562179,15
15110,Valle de Bravo,61599,30296,31303,-0.016347667981623078,15
15109,Tultitlán,486998,238340,248658,-0.021186945326264174,15
15108,Tultepec,131567,64287,67280,-0.022748865596996206,15
15107,Tonatico,12099,5799,6300,-0.041408380857922145,15
15106,Toluca,819561,394836,424725,-0.03646952453813688,15
15105,Tlatlaya,32997,16074,16923,-0.025729611782889353,15
15103,Tlalmanalco,46130,22333,23797,-0.03173639713852157,15
15102,Timilpan,15391,7389,8002,-0.03982847118445845,15
15101,Tianguistenco,70682,34277,36405,-0.030106674966752497,15
15100,Tezoyuca,35199,17404,17795,-0.011108270121310264,15
15099,Texcoco,235151,115648,119503,-0.016393721481090872,15
15098,Texcalyacac,5111,2506,2605,-0.01936998630405009,15
15097,Texcaltitlán,17390,8366,9024,-0.03783783783783784,15
15096,Tequixquiac,33907,16794,17113,-0.0094080868257292,15
15095,Tepotzotlán,88559,43521,45038,-0.017129823055815896,15
15094,Tepetlixpa,18327,9003,9324,-0.017515141594368965,15
15093,Tepetlaoxtoc,27944,13714,14230,-0.018465502433438304,15
15092,Teotihuacán,53010,26000,27010,-0.01905300886625165,15
15091,Teoloyucan,63115,31240,31875,-0.010060999762338589,15
15090,Tenango del Valle,77965,38072,39893,-0.023356634387225038,15
15089,Tenango del Aire,10578,5164,5414,-0.023633957269805255,15
15087,Temoaya,90010,43963,46047,-0.02315298300188868,15
15086,Temascaltepec,32870,16142,16728,-0.017827806510495894,15
15085,Temascalcingo,62695,30220,32475,-0.03596778052476274,15
15084,Temascalapa,35987,17916,18071,-0.004307110901158752,15
15083,Temamatla,11206,5447,5759,-0.027842227378190254,15
15081,Tecámac,364579,177713,186866,-0.02510566982738995,15
15080,Sultepec,25809,12267,13542,-0.04940137161455306,15
15079,Soyaniquilpan de Juárez,11798,5778,6020,-0.02051195117816579,15
15078,Santo Tomás,9111,4458,4653,-0.02140270003292723,15
15077,San Simón de Guerrero,6272,3026,3246,-0.035076530612244895,15
15076,San Mateo Atenco,72579,35597,36982,-0.019082654762396838,15
15074,San Felipe del Progreso,121396,58173,63223,-0.04159939371972717,15
15073,San Antonio la Isla,22152,10886,11266,-0.017154207295052366,15
15072,Rayón,12748,6252,6496,-0.019140257295262003,15
15071,Polotitlán,13002,6364,6638,-0.02107368097215813,15
15070,La Paz,253845,123956,129889,-0.023372530481199156,15
15068,Ozumba,27207,13077,14130,-0.0387032748924909,15
15067,Otzolotepec,78146,38318,39828,-0.019322806029739206,15
15066,Otzoloapan,4864,2464,2400,0.013157894736842105,15
15064,El Oro,34446,16829,17617,-0.02287638622771875,15
15063,Ocuilan,31803,15540,16263,-0.0227337043675125,15
15062,Ocoyoacac,61805,30365,31440,-0.017393414772267617,15
15061,Nopaltepec,8895,4427,4468,-0.004609331084879146,15
15060,Nicolás Romero,366602,180139,186463,-0.017250315055564343,15
15059,Nextlalpan,31691,15637,16054,-0.013158309930264112,15
15058,Nezahualcóyotl,1110565,536943,573622,-0.03302733293413713,15
15057,Naucalpan de Juárez,833779,404974,428805,-0.02858191439218306,15
15055,Mexicaltzingo,11712,5658,6054,-0.03381147540983607,15
15054,Metepec,214162,103059,111103,-0.03756035150960488,15
15053,Melchor Ocampo,50240,24570,25670,-0.021894904458598725,15
15052,Malinalco,25624,12585,13039,-0.017717764595691538,15
15051,Lerma,134799,66669,68130,-0.010838359335009904,15
15050,Juchitepec,23497,11503,11994,-0.02089628463208069,15
15048,Jocotitlán,61204,29503,31701,-0.03591268544539573,15
15047,Jiquipilco,69031,33299,35732,-0.03524503483941997,15
15046,Jilotzingo,17970,8864,9106,-0.013466889259877574,15
15045,Jilotepec,83755,41088,42667,-0.018852605814578233,15
15043,Xalatlaco,26865,13058,13807,-0.027880141447980643,15
15042,Ixtlahuaca,141482,68388,73094,-0.033262181761637526,15
15041,Ixtapan del Oro,6629,3326,3303,0.0034696032584100164,15
15040,Ixtapan de la Sal,33541,16082,17459,-0.041054232133806386,15
15039,Ixtapaluca,467361,227846,239515,-0.02496785140394684,15
15038,Isidro Fabela,10308,5097,5211,-0.011059371362048894,15
15037,Huixquilucan,242167,116502,125665,-0.03783752534408074,15
15036,Hueypoxtla,39864,19860,20004,-0.003612281757977122,15
15035,Huehuetoca,100023,49372,50651,-0.012787058976435419,15
15034,Ecatzingo,9369,4582,4787,-0.021880670295655887,15
15033,Ecatepec de Morelos,1656107,806443,849664,-0.026097951400483183,15
15032,Donato Guerra,33455,16484,16971,-0.014556867433866388,15
15031,Chimalhuacán,614453,302297,312156,-0.016045165374731673,15
15030,Chiconcuac,22819,11138,11681,-0.02379595950742802,15
15029,Chicoloapan,175053,85377,89676,-0.024558276636218745,15
15028,Chiautla,26191,12759,13432,-0.025695849719369248,15
15027,Chapultepec,9676,4738,4938,-0.02066969822240595,15
15026,Chapa de Mota,27551,13532,14019,-0.017676309389858806,15
15025,Chalco,310130,151403,158727,-0.023615903008415824,15
15024,Cuautitlán,140059,69079,70980,-0.01357285144117836,15
15023,Coyotepec,39030,19282,19748,-0.01193953369203177,15
15022,Cocotitlán,12142,5976,6166,-0.015648163399769394,15
15021,Coatepec Harinas,36174,17472,18702,-0.03400232210980262,15
15020,Coacalco de Berriozábal,278064,134141,143923,-0.03517895160826284,15
15019,Capulhuac,34101,16541,17560,-0.02988182164745902,15
15018,Calimaya,47033,23061,23972,-0.019369378946697,15
15017,Ayapango,8864,4353,4511,-0.01782490974729242,15
15016,Axapusco,25559,12666,12893,-0.008881411635822997,15
15015,Atlautla,27663,13396,14267,-0.0314861005675451,15
15014,Atlacomulco,93718,44905,48813,-0.04169956678546277,15
15013,Atizapán de Zaragoza,489937,238124,251813,-0.027940327021637477,15
15011,Atenco,56243,27933,28310,-0.006703056380349555,15
15010,Apaxco,27521,13576,13945,-0.013407943025326115,15
15009,Amecameca,48421,23240,25181,-0.040085913136862106,15
15008,Amatepec,26334,12799,13535,-0.027948659527606896,15
15007,Amanalco,22868,11224,11644,-0.01836627601889103,15
15006,Almoloya del Río,10886,5199,5687,-0.04482821973176557,15
15005,Almoloya de Juárez,147653,73783,73870,-0.0005892193182664761,15
15003,Aculco,44823,22043,22780,-0.016442451420029897,15
15002,Acolman,136558,68392,68166,0.001654974443093777,15
15001,Acambay,60918,29449,31469,-0.03315932893397682,15
17029,Yautepec,97827,47581,50246,-0.02724196796385456,17
17014,Mazatepec,9456,4578,4878,-0.031725888324873094,17
17020,Tepoztlán,41629,20291,21338,-0.02515073626558409,17
17018,Temixco,108126,52374,55752,-0.03124132955995783,17
17007,Cuernavaca,365168,172901,192267,-0.05303312447969154,17
17028,Xochitepec,63382,32161,31221,0.01483070903411063,17
17005,Coatlán del Río,9471,4684,4787,-0.010875303558230388,17
17015,Miacatlán,24990,12107,12883,-0.031052420968387354,17
17009,Huitzilac,17340,8527,8813,-0.01649365628604383,17
17016,Ocuituco,16858,8273,8585,-0.01850753351524499,17
17030,Yecapixtla,46809,22967,23842,-0.018692986391505906,17
17032,Zacualpan,9087,4452,4635,-0.020138659623638165,17
17022,Tetela del Volcán,19138,9207,9931,-0.03783049430452503,17
17027,Totolapan,10789,5247,5542,-0.027342663824265454,17
17026,Tlayacapan,16543,8102,8441,-0.020492051018557698,17
17023,Tlalnepantla,6636,3330,3306,0.003616636528028933,17
17006,Cuautla,175207,83676,91531,-0.04483268362565423,17
17002,Atlatlahucan,18895,9240,9655,-0.02196348240275205,17
17004,Ayala,78866,38186,40680,-0.03162325970633733,17
17031,Zacatepec,35063,16934,18129,-0.034081510424093776,17
17008,Emiliano Zapata,83485,40761,42724,-0.02351320596514344,17
17011,Jiutepec,196953,94766,102187,-0.03767904017709809,17
17012,Jojutla,55115,26430,28685,-0.0409144516011975,17
17001,Amacuzac,17021,8223,8798,-0.03378179895423301,17
17021,Tetecala,7441,3680,3761,-0.010885633651390942,17
17017,Puente de Ixtla,61585,30152,31433,-0.02080051960704717,17
17033,Temoac,14641,6916,7725,-0.05525578853903422,17
17013,Jonacatepec,14604,7002,7602,-0.041084634346754315,17
17010,Jantetelco,15646,7629,8017,-0.024798670586731433,17
17024,Tlaltizapán,48881,23865,25016,-0.023546981444733127,17
17025,Tlaquiltenango,31534,15608,15926,-0.010084353396334116,17
17019,Tepalcingo,25346,12280,13066,-0.031010810384281544,17
17003,Axochiapan,33695,16458,17237,-0.023119157144977,17
25012,Mazatlán,438434,216266,222168,-0.01346154723401926,25
25017,Sinaloa,88282,44862,43420,0.01633402052513536,25
25006,Culiacán,858638,422507,436131,-0.015866989348246874,25
25018,Navolato,135603,68393,67210,0.008723995781804238,25
25016,San Ignacio,22527,11699,10828,0.03866471345496515,25
25015,Salvador Alvarado,79085,38864,40221,-0.01715875324018461,25
25014,Rosario,49380,25152,24228,0.018712029161603888,25
25013,Mocorito,45847,23647,22200,0.03156149802604314,25
25011,Guasave,285912,142031,143881,-0.006470522398500238,25
25010,El Fuerte,97536,49693,47843,0.01896735564304462,25
25009,Escuinapa,54131,27301,26830,0.008701113964271858,25
25008,Elota,42907,22032,20875,0.026965297037779383,25
25007,Choix,32998,17116,15882,0.03739620583065641,25
25005,Cosalá,16697,8542,8155,0.023177816374198957,25
25004,Concordia,28493,14532,13961,0.020040009826975045,25
25003,Badiraguato,29999,15524,14475,0.03496783226107537,25
25001,Ahome,416299,205435,210864,-0.013041107473234382,25
25002,Angostura,44993,22605,22388,0.004822972462383037,25
26026,Etchojoa,60717,31131,29586,0.02544592124116804,26
26042,Navojoa,157729,78242,79487,-0.007893285318489308,26
26012,Bácum,22821,11581,11240,0.014942377634634766,26
26033,Huatabampo,79313,40128,39185,0.011889601956804054,26
26032,Huásabas,962,513,449,0.06652806652806653,26
26048,Puerto Peñasco,57342,29460,27882,0.027519095950612117,26
26017,Caborca,81309,41370,39939,0.017599527727557834,26
26050,Rayón,1599,852,747,0.06566604127579738,26
26049,Quiriego,3356,1797,1559,0.07091775923718713,26
26047,Pitiquito,9468,4936,4532,0.04267004647232784,26
26046,Oquitoa,443,218,225,-0.01580135440180587,26
26045,Opodepe,2878,1538,1340,0.06879777623349548,26
26044,Onavas,399,214,185,0.07268170426065163,26
26043,Nogales,220292,111295,108997,0.010431608955386487,26
26041,Nacozari de García,12751,6575,6176,0.0312916633989491,26
26040,Nácori Chico,2051,1080,971,0.05314480741101901,26
26039,Naco,6401,3238,3163,0.011716919231370098,26
26038,Moctezuma,4680,2351,2329,0.004700854700854701,26
26037,Mazatán,1350,708,642,0.04888888888888889,26
26036,Magdalena,29707,14848,14859,-0.00037028309825966945,26
26035,Imuris,12316,6248,6068,0.014615134784020786,26
26034,Huépac,1154,593,561,0.02772963604852686,26
26031,Huachinera,1350,701,649,0.03851851851851852,26
26068,Villa Pesqueira,1254,688,566,0.09728867623604466,26
26028,Granados,1150,595,555,0.034782608695652174,26
26027,Fronteras,8639,4467,4172,0.0341474707720801,26
26025,Empalme,54131,26996,27135,-0.002567844673107831,26
26024,Divisaderos,813,421,392,0.03567035670356704,26
26023,Cumpas,6362,3248,3114,0.021062558943728386,26
26022,Cucurpe,958,532,426,0.11064718162839249,26
26021,La Colorada,1663,922,741,0.10883944678292243,26
26020,Carbó,5347,2854,2493,0.06751449410884608,26
26019,Cananea,32936,16415,16521,-0.003218362885596308,26
26018,Cajeme,409310,202700,206610,-0.00955266179668222,26
26016,Benjamín Hill,5275,2651,2624,0.0051184834123222745,26
26015,Bavispe,1454,774,680,0.06464924346629987,26
26014,Baviácora,3560,1833,1727,0.029775280898876405,26
26013,Banámichi,1646,841,805,0.02187120291616039,26
26011,Bacoachi,1646,834,812,0.013365735115431349,26
26010,Bacerac,1467,761,706,0.03749147920927062,26
26009,Bacanora,784,417,367,0.06377551020408163,26
26008,Bacadéhuachi,1252,667,585,0.06549520766773163,26
26007,Atil,625,326,299,0.0432,26
26006,Arizpe,3037,1571,1466,0.03457359236088245,26
26005,Arivechi,1253,650,603,0.03750997605746209,26
26004,Altar,9049,4624,4425,0.021991380263012488,26
26003,Alamos,25848,13497,12351,0.04433611884865367,26
26002,Agua Prieta,79138,40117,39021,0.013849225403725138,26
26001,Aconchi,2637,1405,1232,0.06560485400075844,26
26072,San Ignacio Río Muerto,14136,7297,6839,0.03239954725523486,26
26071,Benito Juárez,22009,11088,10921,0.0075878049888681905,26
26070,General Plutarco Elías Calles,15652,8104,7548,0.03552261691796575,26
26069,Yécora,6046,3064,2982,0.013562686073436983,26
26067,Villa Hidalgo,1738,893,845,0.02761795166858458,26
26066,Ures,9185,4711,4474,0.025802939575394666,26
26065,Tubutama,1735,904,831,0.04207492795389049,26
26064,Trincheras,1731,938,793,0.08376660889659157,26
26063,Tepache,1365,716,649,0.04908424908424908,26
26062,Suaqui Grande,1121,604,517,0.07760927743086529,26
26061,Soyopa,1284,716,568,0.11526479750778816,26
26060,Sáric,2703,1423,1280,0.05290418054014059,26
26059,Santa Cruz,1998,1015,983,0.016016016016016016,26
26058,Santa Ana,16014,7961,8053,-0.0057449731484950665,26
26057,San Pedro de la Cueva,1604,856,748,0.06733167082294264,26
26056,San Miguel de Horcasitas,8382,4592,3790,0.09568122166547363,26
26054,San Javier,492,277,215,0.12601626016260162,26
26053,San Felipe de Jesús,396,202,194,0.020202020202020204,26
26052,Sahuaripa,6020,3109,2911,0.03289036544850498,26
26051,Rosario,5226,2737,2489,0.047455032529659394,26
26055,San Luis Río Colorado,178380,90545,87835,0.015192286130732145,26
02004,Tijuana,1559683,783653,776030,0.004887531633030558,02
02003,Tecate,101079,53323,47756,0.055075732842628046,02
02005,Playas de Rosarito,90668,46301,44367,0.021330568668107824,02
02002,Mexicali,936826,473203,463623,0.010226018492228012,02
02001,Ensenada,466814,235130,231684,0.007381955125596062,02
26029,Guaymas,149299,74740,74559,0.0012123322996135271,26
26030,Hermosillo,784342,392697,391645,0.001341251647878094,26
03009,Loreto,16738,8882,7856,0.06129764607479986,03
03003,La Paz,251871,126397,125474,0.003664574325746116,03
03002,Mulegé,59114,30617,28497,0.03586290895557736,03
03001,Comondú,70816,36436,34380,0.02903298689561681,03
03008,Los Cabos,238487,123101,115386,0.0323497716856684,03
06009,Tecomán,112726,56804,55922,0.007824281887053563,06
06007,Manzanillo,161420,81007,80413,0.003679841407508363,06
06001,Armería,28695,14456,14239,0.00756229308241854,06
06004,Coquimatlán,19385,9709,9676,0.0017023471756512768,06
06010,Villa de Álvarez,119956,58357,61599,-0.02702657641135083,06
06003,Comala,20888,10543,10345,0.009479126771351973,06
06008,Minatitlán,8174,4196,3978,0.02666992904330805,06
06002,Colima,146904,71556,75348,-0.025812775690246693,06
06006,Ixtlahuacán,5300,2679,2621,0.010943396226415094,06
06005,Cuauhtémoc,27107,13483,13624,-0.005201608440624193,06
18001,Acaponeta,36572,18289,18283,0.00016405993656349119,18
18002,Ahuacatlán,15229,7621,7608,0.0008536345131000065,18
18003,Amatlán de Cañas,11188,5665,5523,0.01269217018233822,18
18005,Huajicori,11400,5818,5582,0.020701754385964912,18
18006,Ixtlán del Río,27273,13181,14092,-0.0334029993033403,18
18007,Jala,17698,8740,8958,-0.012317776019889252,18
18008,Xalisco,49102,24037,25065,-0.020936010753126146,18
18009,Del Nayar,34300,17268,17032,0.006880466472303207,18
18011,Ruíz,23469,11861,11608,0.010780178107290468,18
18013,San Pedro Lagunillas,7510,3778,3732,0.006125166444740347,18
18014,Santa María del Oro,22412,11412,11000,0.018383009102266642,18
18016,Tecuala,39756,20212,19544,0.016802495220847168,18
18017,Tepic,380249,185167,195082,-0.026075019263693003,18
18018,Tuxpan,30030,14923,15107,-0.006127206127206127,18
18019,La Yesca,13600,6898,6702,0.014411764705882353,18
18020,Bahía de Banderas,124205,62999,61206,0.01443581176281148,18
18004,Compostela,70399,35413,34986,0.006065427065725365,18
18015,Santiago Ixcuintla,93074,47136,45938,0.012871478608419107,18
18012,San Blas,43120,23123,19997,0.07249536178107607,18
18010,Rosamorada,34393,17466,16927,0.0156717936789463,18
14067,Puerto Vallarta,255681,128577,127104,0.0057610851021389934,14
14043,La Huerta,23428,11845,11583,0.011183199590233908,14
14081,Santa María de los Ángeles,3726,1758,1968,-0.05636070853462158,14
14041,Huejúcar,6084,2905,3179,-0.04503616042077581,14
14042,Huejuquilla el Alto,8781,4237,4544,-0.034961849447671105,14
14115,Villa Guerrero,5638,2785,2853,-0.012061014544164597,14
14104,Totatiche,4435,2209,2226,-0.0038331454340473506,14
14025,Colotlán,18091,8711,9380,-0.036979713669780555,14
14061,Mezquitic,18084,8745,9339,-0.032846715328467155,14
14116,Villa Hidalgo,18711,9043,9668,-0.03340281118058896,14
14064,Ojuelos de Jalisco,30097,14636,15461,-0.02741136990397714,14
14031,Chimaltitán,3771,1869,1902,-0.008750994431185362,14
14019,Bolaños,6820,3384,3436,-0.007624633431085044,14
14076,San Martín de Bolaños,3405,1704,1701,0.000881057268722467,14
14060,Mexticacán,6034,2777,3257,-0.07954922108054359,14
14072,San Diego de Alejandría,6647,3172,3475,-0.04558447419888671,14
14074,San Julián,15454,7296,8158,-0.05577843923903197,14
14071,San Cristóbal de la Barranca,3176,1583,1593,-0.0031486146095717885,14
14046,Jalostotitlán,31948,15598,16350,-0.023538249655690496,14
14118,Yahualica de González Gallo,22284,10586,11698,-0.049901274457009516,14
14117,Cañadas de Obregón,4152,2015,2137,-0.029383429672447014,14
14040,Hostotipaquillo,10284,5501,4783,0.06981719175418125,14
14075,San Marcos,3762,1918,1844,0.019670388091440724,14
14029,Cuquío,17795,8488,9307,-0.04602416409103681,14
14007,San Juanito de Escobedo,8896,4461,4435,0.002922661870503597,14
14055,Magdalena,21321,10583,10738,-0.0072698278692369025,14
14094,Tequila,40697,20148,20549,-0.009853306140501757,14
14036,Etzatlán,18632,9157,9475,-0.017067410905968226,14
14003,Ahualulco de Mercado,21714,10677,11037,-0.01657916551533573,14
14095,Teuchitlán,9088,4425,4663,-0.02618838028169014,14
14080,San Sebastián del Oeste,5755,3008,2747,0.045351867940920935,14
14038,Guachinango,4323,2178,2145,0.007633587786259542,14
14048,Jesús María,18634,8571,10063,-0.08006869163893958,14
14039,Guadalajara,1495189,717404,777785,-0.04038352342078493,14
14078,San Miguel el Alto,31166,14999,16167,-0.03747673747032022,14
14105,Tototlán,21871,10668,11203,-0.02446161583832472,14
14123,Zapotlán del Rey,17585,8671,8914,-0.013818595393801536,14
14013,Atotonilco el Alto,57717,28217,29500,-0.02222915258935842,14
14006,Ameca,57340,28013,29327,-0.022915940006975933,14
14044,Ixtlahuacán de los Membrillos,41060,20419,20641,-0.005406721870433512,14
14002,Acatlán de Juárez,23241,12220,11021,0.051589862742567015,14
14062,Mixtlán,3574,1800,1774,0.007274762171236709,14
14033,Degollado,21132,10119,11013,-0.04230550823395798,14
14077,San Martín Hidalgo,26306,12785,13521,-0.027978407967764008,14
14016,Ayotlán,38291,18603,19688,-0.028335640228774387,14
14045,Ixtlahuacán del Río,19005,9175,9830,-0.03446461457511181,14
14004,Amacueca,5545,2674,2871,-0.03552750225428314,14
14052,Juchitlán,5515,2637,2878,-0.04369900271985494,14
14008,Arandas,72812,35135,37677,-0.03491182772070538,14
14125,San Ignacio Cerro Gordo,17626,8501,9125,-0.035402246681039376,14
14083,Tala,69031,34313,34718,-0.005866929350581623,14
14120,Zapopan,1243756,607907,635849,-0.022465821270409952,14
14070,El Salto,138226,69006,69220,-0.0015481891974013571,14
14009,El Arenal,17545,8631,8914,-0.016129951553149044,14
14005,Amatitán,14648,7273,7375,-0.006963407973784817,14
14091,Teocaltiche,40105,18973,21132,-0.05383368657274654,14
14111,Valle de Guadalupe,6705,3333,3372,-0.0058165548098434005,14
14093,Tepatitlán de Morelos,136123,66244,69879,-0.026703789954673346,14
14035,Encarnación de Díaz,51396,24692,26704,-0.03914701533193245,14
14073,San Juan de los Lagos,65219,32066,33153,-0.016666922215918673,14
14053,Lagos de Moreno,153817,74472,79345,-0.031680503455404796,14
14109,Unión de San Antonio,17325,8306,9019,-0.04115440115440115,14
14089,Techaluta de Montenegro,3511,1722,1789,-0.019082882369695242,14
14082,Sayula,34829,16733,18096,-0.03913405495420483,14
14102,Tonaya,5930,2874,3056,-0.03069139966273187,14
14086,Tapalpa,18096,8848,9248,-0.022104332449160036,14
14112,Valle de Juárez,5798,2806,2992,-0.03208002759572266,14
14068,Villa Purificación,11623,5933,5690,0.02090682267917061,14
14054,El Limón,5499,2752,2747,0.0009092562284051646,14
14034,Ejutla,2082,1072,1010,0.029779058597502402,14
14014,Atoyac,8276,3962,4314,-0.04253262445625906,14
14026,Concepción de Buenos Aires,5933,3011,2922,0.01500084274397438,14
14079,Gómez Farías,14011,6778,7233,-0.03247448433373778,14
14110,Unión de Tula,13737,6620,7117,-0.03617966077018272,14
14037,El Grullo,23845,11622,12223,-0.02520444537638918,14
14098,Tlaquepaque,608114,299904,308210,-0.013658623218672814,14
14101,Tonalá,478689,243241,235448,0.016279881091898915,14
14051,Juanacatlán,13218,6675,6543,0.009986382206082615,14
14001,Acatic,21206,10348,10858,-0.02404979722719985,14
14124,Zapotlanejo,63636,31114,32522,-0.022125840719089823,14
14097,Tlajomulco de Zúñiga,416626,206958,209668,-0.006504634852361591,14
14057,La Manzanilla de la Paz,3755,1790,1965,-0.04660452729693742,14
14059,Mazamitla,13225,6288,6937,-0.04907372400756144,14
14096,Tizapán el Alto,20857,10163,10694,-0.02545907848683895,14
14092,Teocuitatlán de Corona,10837,5307,5530,-0.020577650641321398,14
14032,Chiquilistlán,5814,2896,2918,-0.003783969728242174,14
14107,Tuxcueca,6316,3054,3262,-0.032932235592146926,14
14088,Tecolotlán,16573,8292,8281,0.0006637301635189766,14
14017,Ayutla,12664,6308,6356,-0.003790271636133923,14
14100,Tomatlán,35050,17822,17228,0.016947218259629103,14
14090,Tenamaxtlán,7051,3495,3556,-0.008651255141114736,14
14020,Cabo Corrientes,10029,5176,4853,0.032206600857513215,14
14018,La Barca,64269,30920,33349,-0.03779427095489272,14
14010,Atemajac de Brizuela,6655,3303,3352,-0.007362885048835462,14
14024,Cocula,26174,12721,13453,-0.027966684496064795,14
14114,Villa Corona,16969,8357,8612,-0.015027402911190995,14
14012,Atenguillo,4115,2014,2101,-0.021142162818955042,14
14119,Zacoalco de Torres,27901,13698,14203,-0.01809970968782481,14
14011,Atengo,5400,2797,2603,0.035925925925925924,14
14028,Cuautla,2171,1045,1126,-0.037309995393827726,14
14058,Mascota,14245,7010,7235,-0.015795015795015795,14
14084,Talpa de Allende,14410,7215,7195,0.0013879250520471894,14
14030,Chapala,48839,23902,24937,-0.021192080099920147,14
14050,Jocotepec,42164,20839,21325,-0.011526420643202731,14
14066,Poncitlán,48408,23721,24687,-0.019955379276152704,14
14063,Ocotlán,92967,45453,47514,-0.022169156797573333,14
14047,Jamay,22881,11337,11544,-0.009046807394781697,14
14113,San Gabriel,15310,7507,7803,-0.019333768778576094,14
14121,Zapotiltic,29192,14181,15011,-0.028432447245820773,14
14015,Autlán de Navarro,57559,28210,29349,-0.019788391042234923,14
14106,Tuxcacuesco,4234,2168,2066,0.024090694378837978,14
14023,Zapotlán el Grande,100534,48661,51873,-0.031949390256032786,14
14069,Quitupan,8691,4066,4625,-0.06431941088482337,14
14065,Pihuamo,12119,6045,6074,-0.0023929367109497483,14
14022,Cihuatlán,39020,19694,19326,0.009431060994361865,14
14122,Zapotitlán de Vadillo,6685,3328,3357,-0.004338070306656694,14
14103,Tonila,7256,3573,3683,-0.01515986769570011,14
14108,Tuxpan,34182,16442,17740,-0.03797320227020069,14
14087,Tecalitlán,16847,8220,8627,-0.024158603905739894,14
14056,Santa María del Oro,2517,1273,1244,0.011521652761223678,14
14021,Casimiro Castillo,21475,10667,10808,-0.006565774155995343,14
14027,Cuautitlán de García Barragán,17322,8763,8559,0.011776931070315206,14
14085,Tamazula de Gordiano,37986,18512,19474,-0.025325119780971937,14
14049,Jilotlán de los Dolores,9545,4905,4640,0.02776322682032478,14
14099,Tolimán,9591,4724,4867,-0.014909811281409655,14
16108,Zamora,186102,89746,96356,-0.035518156709761314,16
16085,Tangancícuaro,32677,15740,16937,-0.03663126970040089,16
16052,Lázaro Cárdenas,178817,89221,89596,-0.0020971160460135224,16
16008,Aquila,23536,11917,11619,0.012661454792658056,16
16010,Arteaga,21790,10846,10944,-0.004497475906379073,16
16096,Tumbiscatío,7890,3972,3918,0.006844106463878327,16
16077,San Lucas,18461,9044,9417,-0.020204755972049186,16
16014,Coahuayana,14136,7256,6880,0.02659875495189587,16
16038,Huetamo,41937,20531,21406,-0.02086463027875146,16
16029,Churumuco,14366,7167,7199,-0.0022274815536683836,16
16026,Chinicuila,5271,2696,2575,0.0229557958641624,16
16015,Coalcomán de Vázquez Pallares,17615,8601,9014,-0.023445926766959977,16
16002,Aguililla,16214,8174,8040,0.008264462809917356,16
16035,La Huacana,32757,16176,16581,-0.012363769575968495,16
16055,Múgica,44963,22135,22828,-0.015412672641950047,16
16097,Turicato,31877,15364,16513,-0.036044797189195975,16
16013,Carácuaro,9212,4617,4595,0.0023881893182805037,16
16089,Tepalcatepec,22987,11559,11428,0.005698873276199591,16
16006,Apatzingán,123649,60907,62742,-0.014840394989041562,16
16064,Parácuaro,25343,12681,12662,0.0007497139249496902,16
16057,Nocupétaro,7799,3835,3964,-0.01654058212591358,16
16059,Nuevo Urecho,8240,4101,4139,-0.004611650485436893,16
16033,Gabriel Zamora,21294,10500,10794,-0.013806706114398421,16
16009,Ario,34848,16925,17923,-0.028638659320477503,16
16081,Susupuato,8704,4310,4394,-0.009650735294117647,16
16092,Tiquicheo de Nicolás Romero,14274,7143,7131,0.0008406893652795292,16
16046,Juárez,13604,6592,7012,-0.03087327256689209,16
16087,Taretan,13558,6636,6922,-0.02109455671928013,16
16012,Buenavista,42234,21308,20926,0.009044845385234646,16
16082,Tacámbaro,69955,34010,35945,-0.027660638982202845,16
16099,Tuzantla,16305,8060,8245,-0.01134621281815394,16
16079,Salvador Escalante,45217,21796,23421,-0.0359378110002875,16
16111,Ziracuaretiro,15222,7441,7781,-0.022336092497700695,16
16058,Nuevo Parangaricutiro,18834,9108,9726,-0.03281299776999044,16
16083,Tancítaro,29414,14727,14687,0.001359896647854763,16
16047,Jungapeo,19986,9762,10224,-0.02311618132692885,16
16049,Madero,17427,8700,8727,-0.0015493200206576003,16
16001,Acuitzio,10987,5259,5728,-0.04268681168653864,16
16112,Zitácuaro,155534,74715,80819,-0.03924543829644965,16
16039,Huiramba,7925,3883,4042,-0.020063091482649842,16
16066,Pátzcuaro,87794,41827,45967,-0.047155842084880516,16
16068,Peribán,25296,12566,12730,-0.006483238456672992,16
16090,Tingambato,13950,6731,7219,-0.0349820788530466,16
16102,Uruapan,315350,152442,162908,-0.03318852069129539,16
16048,Lagunillas,5506,2665,2841,-0.03196512895023611,16
16061,Ocampo,22628,11242,11386,-0.006363797065582464,16
16098,Tuxpan,26026,12502,13524,-0.0392684238838085,16
16100,Tzintzuntzan,13556,6344,7212,-0.06403068751844201,16
16101,Tzitzio,9166,4633,4533,0.010909884355225835,16
16005,Angangueo,10768,5201,5567,-0.033989598811292716,16
16007,Aporo,3218,1537,1681,-0.044748290863890615,16
16032,Erongarícuaro,14555,7005,7550,-0.037444177258673994,16
16065,Paracho,34721,16422,18299,-0.054059502894501885,16
16056,Nahuatzen,27174,13090,14084,-0.03657908294693457,16
16073,Quiroga,25592,12109,13483,-0.05368865270396999,16
16041,Irimbo,14766,6983,7783,-0.05417851821752675,16
16022,Charo,21723,11463,10260,0.05537909128573401,16
16024,Cherán,18141,8701,9440,-0.040736453337743235,16
16075,Los Reyes,64141,31265,32876,-0.025116540122542524,16
16021,Charapan,12163,5649,6514,-0.07111732302885801,16
16080,Senguio,18427,8829,9598,-0.041732240733705975,16
16072,Queréndaro,13550,6546,7004,-0.03380073800738007,16
16095,Tocumbo,11504,5674,5830,-0.013560500695410291,16
16053,Morelia,729279,348994,380285,-0.04290676133551083,16
16093,Tlalpujahua,27587,13104,14483,-0.04998731286475514,16
16034,Hidalgo,117620,56532,61088,-0.03873490902907669,16
16040,Indaparapeo,16427,7886,8541,-0.03987337919279235,16
16088,Tarímbaro,78623,37951,40672,-0.034608193531155004,16
16091,Tingüindín,13511,6448,7063,-0.04551846643475686,16
16019,Cotija,19644,9259,10385,-0.05732030136428426,16
16025,Chilchota,36293,17360,18933,-0.043341691235224425,16
16016,Coeneo,20492,9360,11132,-0.08647276986140932,16
16110,Zinapécuaro,46666,22275,24391,-0.04534350490721296,16
16037,Huaniqueo,7983,3639,4344,-0.08831266441187524,16
16003,Álvaro Obregón,20913,9984,10929,-0.04518720413140152,16
16027,Chucándiro,5166,2320,2846,-0.10181958962446767,16
16018,Copándaro,8952,4191,4761,-0.06367292225201072,16
16044,Jiménez,13275,6285,6990,-0.05310734463276836,16
16070,Purépero,15306,7423,7883,-0.030053573761923427,16
16107,Zacapu,73455,35300,38155,-0.03886733374174665,16
16084,Tangamandapio,27822,13277,14545,-0.04557544389332183,16
16043,Jacona,64011,30951,33060,-0.03294746215494212,16
16050,Maravatío,80258,38228,42030,-0.04737222457574323,16
16036,Huandacareo,11592,5399,6193,-0.06849551414768806,16
16054,Morelos,8091,3630,4461,-0.10270671116054876,16
16020,Cuitzeo,28227,13253,14974,-0.06096999326885606,16
16078,Santa Ana Maya,12618,5767,6851,-0.08590901886194326,16
16017,Contepec,32954,16007,16947,-0.02852461006251138,16
16045,Jiquilpan,34199,16134,18065,-0.05646363928769847,16
16094,Tlazazalca,6890,3344,3546,-0.029317851959361395,16
16104,Villamar,16991,8063,8928,-0.050909304926137364,16
16051,Marcos Castellanos,13031,6309,6722,-0.03169365359527281,16
16076,Sahuayo,72841,35298,37543,-0.030820554358122487,16
16063,Panindícuaro,16064,7514,8550,-0.06449203187250996,16
16023,Chavinda,9975,4847,5128,-0.028170426065162908,16
16074,Cojumatlán de Régules,9980,4863,5117,-0.025450901803607213,16
16067,Penjamillo,17159,7986,9173,-0.06917652543854537,16
16004,Angamacutiro,14684,6936,7748,-0.055298283846363386,16
16042,Ixtlán,13584,6621,6963,-0.02517667844522968,16
16028,Churintzio,5564,2599,2965,-0.06578001437814522,16
16103,Venustiano Carranza,23457,11527,11930,-0.01718037259666624,16
16062,Pajacuarán,19450,9430,10020,-0.030334190231362468,16
16031,Epitacio Huerta,16218,7785,8433,-0.03995560488346282,16
16109,Zináparo,3247,1479,1768,-0.08900523560209424,16
16030,Ecuandureo,12855,5855,7000,-0.08907040062232595,16
16071,Puruándiro,67837,31746,36091,-0.06405059185989946,16
16011,Briseñas,10653,5138,5515,-0.035389092274476674,16
16060,Numarán,9599,4557,5042,-0.050526096468382124,16
16105,Vista Hermosa,18995,9288,9707,-0.022058436430639643,16
16113,José Sixto Verduzco,25576,12029,13547,-0.05935251798561151,16
16086,Tanhuato,15176,7354,7822,-0.03083816552451239,16
16106,Yurécuaro,29995,14505,15490,-0.032838806467744626,16
16069,La Piedad,99576,47492,52084,-0.04611552984654937,16
10007,Gómez Palacio,327985,161736,166249,-0.01375977559949388,10
10034,Tamazula,26368,13702,12666,0.039290048543689324,10
10037,Topia,8581,4395,4186,0.024356135648525814,10
10038,Vicente Guerrero,21117,10206,10911,-0.033385424065918455,10
10039,Nuevo Ideal,26092,12962,13130,-0.006438755173999693,10
10035,Tepehuanes,10745,5282,5463,-0.016845044206607724,10
10033,Súchil,6761,3240,3521,-0.04156189912734803,10
10027,San Juan de Guadalupe,5947,2930,3017,-0.01462922481923659,10
10031,Santa Clara,7003,3500,3503,-0.0004283878337855205,10
10001,Canatlán,31401,15633,15768,-0.004299226139294927,10
10002,Canelas,4122,2165,1957,0.050460941290635615,10
10003,Coneto de Comonfort,4530,2244,2286,-0.009271523178807948,10
10004,Cuencamé,33664,16961,16703,0.007663973384030418,10
10005,Durango,582267,281702,300565,-0.03239579093439951,10
10008,Guadalupe Victoria,34052,16987,17065,-0.0022906143545166216,10
10010,Hidalgo,4265,2180,2085,0.022274325908558032,10
10011,Indé,5280,2635,2645,-0.001893939393939394,10
10013,Mapimí,25137,12549,12588,-0.0015514977920992959,10
10014,Mezquital,33396,16514,16882,-0.011019283746556474,10
10015,Nazas,12411,6162,6249,-0.007009910563210055,10
10016,Nombre de Dios,18488,9180,9308,-0.006923409779316313,10
10018,El Oro,11320,5668,5652,0.0014134275618374558,10
10019,Otáez,5208,2682,2526,0.029953917050691243,10
10020,Pánuco de Coronado,11927,5905,6022,-0.009809675526117213,10
10021,Peñón Blanco,10473,5309,5164,0.013845125560966294,10
10022,Poanas,24918,12266,12652,-0.015490809856328759,10
10023,Pueblo Nuevo,49162,24407,24755,-0.007078637972417721,10
10024,Rodeo,12788,6402,6386,0.0012511729746637473,10
10025,San Bernardo,3433,1805,1628,0.05155840372851733,10
10026,San Dimas,19691,10039,9652,0.019653648875120614,10
10028,San Juan del Río,11855,5851,6004,-0.012905946857865879,10
10029,San Luis del Cordero,2181,1112,1069,0.019715726730857405,10
10030,San Pedro del Gallo,1709,875,834,0.02399063779988297,10
10032,Santiago Papasquiaro,44966,22382,22584,-0.004492283058310724,10
10006,General Simón Bolívar,10629,5290,5339,-0.004610029165490638,10
10012,Lerdo,141043,69737,71306,-0.011124267067490055,10
10017,Ocampo,9626,4955,4671,0.029503428215250364,10
10009,Guanaceví,10149,5203,4946,0.02532269189082668,10
08006,Bachíniva,6011,3074,2937,0.022791548827150225,08
08019,Chihuahua,819543,399495,420048,-0.025078610884358723,08
08004,Aquiles Serdán,10688,6272,4416,0.17365269461077845,08
08037,Juárez,1332131,665691,666440,-0.0005622570152635139,08
08013,Casas Grandes,10587,5380,5207,0.016340795315008972,08
08050,Nuevo Casas Grandes,59337,29058,30279,-0.0205773800495475,08
08053,Praxedis G. Guerrero,4799,2433,2366,0.013961241925401125,08
08005,Ascensión,23975,12207,11768,0.018310740354535976,08
08025,Gómez Farías,8624,4295,4329,-0.003942486085343228,08
08020,Chínipas,8441,4448,3993,0.05390356592820756,08
08023,Galeana,5892,2941,2951,-0.0016972165648336728,08
08028,Guadalupe,6458,3243,3215,0.004335707649427067,08
08030,Guazapares,8998,4600,4398,0.022449433207379417,08
08035,Janos,10953,5727,5226,0.045740892906053134,08
08040,Madera,29611,14969,14642,0.011043193407855189,08
08041,Maguarichi,1921,994,927,0.034877667881311816,08
08043,Matachí,3104,1578,1526,0.01675257731958763,08
08051,Ocampo,7546,3935,3611,0.04293665518155314,08
08063,Temósachic,6211,3216,2995,0.03558203187892449,08
08065,Urique,20386,10342,10044,0.014617875012263318,08
08066,Uruachi,8200,4150,4050,0.012195121951219513,08
08029,Guadalupe y Calvo,53499,27053,26446,0.011346006467410606,08
08046,Morelos,8343,4285,4058,0.027208438211674457,08
08047,Moris,5312,2775,2537,0.04480421686746988,08
08002,Aldama,22302,11099,11203,-0.004663258900547036,08
08055,Rosales,16785,8526,8259,0.01590705987488829,08
08021,Delicias,137935,68013,69922,-0.013839852104252003,08
08045,Meoqui,43833,21930,21903,0.0006159742659639998,08
08001,Ahumada,11457,5852,5605,0.02155887230514096,08
08017,Cuauhtémoc,154639,75936,78703,-0.017893286945725204,08
08054,Riva Palacio,8012,4076,3936,0.017473789316025962,08
08032,Hidalgo del Parral,107061,51883,55178,-0.030776846844322397,08
08003,Allende,8409,4258,4151,0.012724461886074444,08
08011,Camargo,48748,24032,24716,-0.014031344875687208,08
08036,Jiménez,41265,20564,20701,-0.003320004846722404,08
08038,Julimes,4953,2553,2400,0.030890369473046637,08
08052,Ojinaga,26304,13290,13014,0.010492700729927007,08
08062,Saucillo,32325,16275,16050,0.0069605568445475635,08
08042,Manuel Benavides,1601,871,730,0.08806995627732667,08
08007,Balleza,17672,8980,8692,0.016296966953372568,08
08008,Batopilas,14362,7297,7065,0.016153739033560786,08
08009,Bocoyna,28766,14147,14619,-0.016408259751095042,08
08010,Buenaventura,22378,11287,11091,0.008758602198587899,08
08012,Carichí,8795,4403,4392,0.0012507106310403638,08
08014,Coronado,2284,1184,1100,0.03677758318739054,08
08015,Coyame del Sotol,1681,917,764,0.091017251635931,08
08016,La Cruz,3982,2043,1939,0.026117528879959818,08
08018,Cusihuiriachi,5414,2812,2602,0.03878832656076838,08
08022,Dr. Belisario Domínguez,2911,1478,1433,0.015458605290278255,08
08024,Santa Isabel,3937,1979,1958,0.005334010668021336,08
08026,Gran Morelos,3209,1655,1554,0.03147397943284512,08
08027,Guachochi,49689,24624,25065,-0.008875203767433436,08
08031,Guerrero,39626,19912,19714,0.0049967193256952504,08
08033,Huejotitán,1049,522,527,-0.004766444232602479,08
08034,Ignacio Zaragoza,6934,3534,3400,0.019325064897606,08
08039,López,4025,2101,1924,0.0439751552795031,08
08044,Matamoros,4499,2293,2206,0.01933763058457435,08
08048,Namiquipa,22880,11630,11250,0.016608391608391608,08
08049,Nonoava,2849,1479,1370,0.03825903825903826,08
08056,Rosario,2235,1131,1104,0.012080536912751677,08
08057,San Francisco de Borja,2290,1183,1107,0.03318777292576419,08
08058,San Francisco de Conchos,2983,1549,1434,0.03855179349648005,08
08059,San Francisco del Oro,4753,2399,2354,0.009467704607616242,08
08060,Santa Bárbara,10427,5183,5244,-0.005850196604967872,08
08061,Satevó,3662,1908,1754,0.042053522665210265,08
08064,El Tule,1869,960,909,0.027287319422150885,08
08067,Valle de Zaragoza,5105,2636,2469,0.0327130264446621,08
32027,Melchor Ocampo,2662,1414,1248,0.06235912847483095,32
32007,Concepción del Oro,12803,6448,6355,0.007263922518159807,32
32041,El Salvador,2710,1378,1332,0.016974169741697416,32
32005,Calera,39917,19726,20191,-0.01164917203196633,32
32006,Cañitas de Felipe Pescador,8239,4039,4200,-0.01954120645709431,32
32008,Cuauhtémoc,11915,5818,6097,-0.0234158623583718,32
32010,Fresnillo,213139,104348,108791,-0.02084555149456458,32
32012,Genaro Codina,8104,3984,4120,-0.01678183613030602,32
32013,General Enrique Estrada,5894,2905,2989,-0.014251781472684086,32
32016,General Pánfilo Natera,22346,10976,11370,-0.017631790924550254,32
32020,Jerez,57610,27792,29818,-0.035167505641381706,32
32024,Loreto,48365,23746,24619,-0.018050242944277886,32
32025,Luis Moya,12234,6075,6159,-0.006866110838646395,32
32026,Mazapil,17813,9331,8482,0.047661820019087184,32
32031,Monte Escobedo,8929,4352,4577,-0.025198790458058014,32
32032,Morelos,11493,5690,5803,-0.009832071695814844,32
32035,Noria de Ángeles,15607,7663,7944,-0.018004741462164412,32
32036,Ojocaliente,40740,19749,20991,-0.0304860088365243,32
32037,Pánuco,16875,8407,8468,-0.0036148148148148146,32
32038,Pinos,69844,33973,35871,-0.027174846801443216,32
32039,Río Grande,62693,30198,32495,-0.03663885920278181,32
32040,Sain Alto,21533,10433,11100,-0.030975711698323503,32
32042,Sombrerete,61188,30159,31029,-0.014218474210629535,32
32043,Susticacán,1360,636,724,-0.06470588235294118,32
32046,Tepetongo,7090,3401,3689,-0.04062059238363893,32
32052,Villa García,18269,9035,9234,-0.010892769171821118,32
32053,Villa González Ortega,12893,6177,6716,-0.04180563096253781,32
32054,Villa Hidalgo,18490,9120,9370,-0.01352082206598161,32
32055,Villanueva,29395,14303,15092,-0.02684129954073822,32
32057,Trancoso,16934,8358,8576,-0.012873508916971773,32
32001,Apozol,6314,3067,3247,-0.028508077288565095,32
32002,Apulco,5005,2347,2658,-0.06213786213786214,32
32003,Atolinga,2692,1287,1405,-0.043833580980683504,32
32004,Benito Juárez,4372,2221,2151,0.016010978956999086,32
32011,Trinidad García de la Cadena,3013,1472,1541,-0.022900763358778626,32
32015,El Plateado de Joaquín Amaro,1609,795,814,-0.011808576755748913,32
32018,Huanusco,4306,2096,2210,-0.026474686483975846,32
32019,Jalpa,23557,11380,12177,-0.03383283100564588,32
32023,Juchipila,12284,5863,6421,-0.04542494301530446,32
32028,Mezquital del Oro,2584,1219,1365,-0.0565015479876161,32
32030,Momax,2529,1216,1313,-0.03835508105970739,32
32033,Moyahua de Estrada,4563,2155,2408,-0.0554459785229016,32
32034,Nochistlán de Mejía,27932,13157,14775,-0.05792639266790778,32
32044,Tabasco,15656,7603,8053,-0.02874297393970363,32
32045,Tepechitlán,8215,3934,4281,-0.04223980523432745,32
32047,Teúl de González Ortega,5506,2656,2850,-0.03523428986560116,32
32048,Tlaltenango de Sánchez Román,25493,12470,13023,-0.02169222923939905,32
32058,Santa María de la Paz,2821,1402,1419,-0.006026231832683446,32
32009,Chalchihuites,10565,5103,5462,-0.033980123047799335,32
32021,Jiménez del Teul,4584,2238,2346,-0.02356020942408377,32
32049,Valparaíso,33323,16349,16974,-0.018755814302433754,32
32051,Villa de Cos,34328,17164,17164,0.0,32
32014,General Francisco R. Murguía,21974,10568,11406,-0.0381359788841358,32
32017,Guadalupe,159991,77843,82148,-0.026907763561700347,32
32022,Juan Aldama,20543,9947,10596,-0.03159226987294942,32
32050,Vetagrande,9353,4561,4792,-0.024697957874478777,32
32056,Zacatecas,138176,66297,71879,-0.04039775358962483,32
32029,Miguel Auza,22296,10853,11443,-0.026462145676354503,32
10036,Tlahualilo,22244,11137,11107,0.0013486782952706348,10
07099,La Trinitaria,72769,35593,37176,-0.021753768775165248,07
07102,Tuxtla Chico,37737,18487,19250,-0.020218883324058617,07
07055,Metapa,5033,2432,2601,-0.033578382674349296,07
07115,Maravilla Tenejapa,11451,5835,5616,0.019124967251768404,07
07059,Ocosingo,198877,99113,99764,-0.0032733800288620605,07
07089,Tapachula,320451,154221,166230,-0.03747530823745284,07
07101,Tuxtla Gutiérrez,553374,263941,289433,-0.04606649390827903,07
07027,Chiapa de Corzo,87603,43301,44302,-0.011426549319087246,07
07012,Berriozábal,43179,21562,21617,-0.0012737673406053869,07
07041,La Independencia,41266,20256,21010,-0.018271700673678087,07
07003,Acapetahua,27580,13891,13689,0.007324147933284989,07
07032,Escuintla,30068,14786,15282,-0.016495942530264734,07
07050,La Libertad,4974,2441,2533,-0.018496180136710897,07
07097,Tonalá,84594,41927,42667,-0.00874766531905336,07
07092,Tecpatán,41045,20420,20625,-0.0049945182117188455,07
07090,Tapalapa,4121,2002,2119,-0.028391167192429023,07
07088,Sunuapa,2235,1143,1092,0.022818791946308724,07
07079,San Fernando,33060,16685,16375,0.009376890502117362,07
07074,Reforma,40711,20004,20707,-0.017268060229422025,07
07062,Ostuacán,17067,8614,8453,0.00943340950372063,07
07061,Ocozocoautla de Espinosa,82059,40580,41479,-0.010955531995271694,07
07060,Ocotepec,11878,5893,5985,-0.007745411685468934,07
07048,Juárez,21084,10481,10603,-0.0057863782963384555,07
07043,Ixtacomitán,10176,5077,5099,-0.002161949685534591,07
07033,Francisco León,7000,3540,3460,0.011428571428571429,07
07025,Chapultenango,7332,3660,3672,-0.0016366612111292963,07
07021,Copainalá,21050,10375,10675,-0.014251781472684086,07
07009,Arriaga,40042,19534,20508,-0.024324459317716398,07
07042,Ixhuatán,10239,5070,5169,-0.009668912979783182,07
07040,Huixtla,51359,24914,26445,-0.029809770439455596,07
07039,Huitiupán,22536,11368,11168,0.008874689385871494,07
07038,Huixtán,21507,10599,10908,-0.01436741526014786,07
07037,Huehuetán,33444,16355,17089,-0.021947135510106446,07
07035,Frontera Hidalgo,12665,6229,6436,-0.01634425582313462,07
07034,Frontera Comalapa,67012,32631,34381,-0.02611472572076643,07
07031,Chilón,111554,55205,56349,-0.01025512307940549,07
07030,Chicomuselo,31515,15715,15800,-0.0026971283515786135,07
07029,Chicoasén,5018,2516,2502,0.0027899561578318055,07
07028,Chiapilla,5405,2781,2624,0.02904717853839038,07
07026,Chenalhó,36111,17820,18291,-0.013043117055744787,07
07024,Chanal,10817,5376,5441,-0.00600905981325691,07
07023,Chamula,76941,35555,41386,-0.07578534201531044,07
07022,Chalchihuitán,14027,6919,7108,-0.01347401440079846,07
07020,La Concordia,44082,22120,21962,0.0035842293906810036,07
07019,Comitán de Domínguez,141013,67691,73322,-0.03993248849396864,07
07018,Coapilla,8444,4200,4244,-0.005210800568450971,07
07016,Catazajá,17140,8747,8393,0.020653442240373396,07
07015,Cacahoatán,43811,21417,22394,-0.022300335532172286,07
07014,El Bosque,18559,9090,9469,-0.020421358909424,07
07013,Bochil,30642,15219,15423,-0.006657528881926767,07
07010,Bejucal de Ocampo,7623,3856,3767,0.011675193493375311,07
07008,Angel Albino Corzo,26628,13359,13269,0.0033799008562415502,07
07007,Amatenango del Valle,8728,4183,4545,-0.04147571035747021,07
07006,Amatenango de la Frontera,29547,14447,15100,-0.02210038244153383,07
07005,Amatán,21275,10791,10484,0.014430082256169213,07
07004,Altamirano,29865,15019,14846,0.00579273396952955,07
07002,Acala,28947,14473,14474,-3.4545894220471896e-05,07
07001,Acacoyagua,16814,8436,8378,0.0034495063637444987,07
07119,Santiago el Pinar,3245,1607,1638,-0.009553158705701078,07
07118,San Andrés Duraznal,4545,2195,2350,-0.034103410341034104,07
07117,Montecristo de Guerrero,6900,3474,3426,0.006956521739130435,07
07116,Marqués de Comillas,9856,4993,4863,0.013189935064935064,07
07114,Benemérito de las Américas,17282,8695,8587,0.006249276704085175,07
07113,Aldama,5072,2438,2634,-0.038643533123028394,07
07112,San Juan Cancuc,29016,14154,14862,-0.024400330851943756,07
07111,Zinacantán,36489,17176,19313,-0.05856559511085532,07
07110,San Lucas,6734,3404,3330,0.01098901098901099,07
07109,Yajalón,34028,16644,17384,-0.021746796755613026,07
07108,Villaflores,98618,48595,50023,-0.014480115191952787,07
07107,Villa Corzo,74477,36798,37679,-0.011829155309692925,07
07106,Venustiano Carranza,61341,30774,30567,0.003374578177727784,07
07105,Unión Juárez,14089,6883,7206,-0.022925686705940806,07
07104,Tzimol,14009,6884,7125,-0.017203226497251766,07
07103,Tuzantán,28137,13896,14241,-0.012261435121015034,07
07100,Tumbalá,31723,15591,16132,-0.0170538725845601,07
07098,Totolapa,6375,3189,3186,0.00047058823529411766,07
07094,Teopisca,37607,18230,19377,-0.030499641024277394,07
07093,Tenejapa,40268,19761,20507,-0.018525876626601767,07
07091,Tapilula,12170,6009,6161,-0.01248972884141331,07
07087,Suchiate,35056,17171,17885,-0.02036741214057508,07
07086,Suchiapa,21045,10551,10494,0.00270848182466144,07
07084,Solosuchiapa,8065,4054,4011,0.005331680099194048,07
07083,Socoltenango,17125,8527,8598,-0.004145985401459854,07
07082,Sitalá,12269,6113,6156,-0.003504768114760779,07
07081,Simojovel,40297,19875,20422,-0.013574211479762762,07
07080,Siltepec,38143,19349,18794,0.014550507301470781,07
07077,Salto de Agua,57253,28433,28820,-0.006759471119417323,07
07076,Sabanilla,25187,12606,12581,0.0009925755349982134,07
07075,Las Rosas,25530,12659,12871,-0.008303956130043087,07
07073,Rayón,9002,4482,4520,-0.004221284159075761,07
07072,Pueblo Nuevo Solistahuacán,31075,15104,15971,-0.027900241351568784,07
07071,Villa Comaltitlán,27899,13850,14049,-0.007132872145955052,07
07070,El Porvenir,13201,6586,6615,-0.0021968032724793574,07
07069,Pijijiapan,50079,24803,25276,-0.00944507677868967,07
07068,Pichucalco,29813,14820,14993,-0.0058028376882568004,07
07067,Pantepec,10870,5399,5471,-0.006623735050597976,07
07066,Pantelhó,20589,10226,10363,-0.006654038564281898,07
07065,Palenque,110918,54786,56132,-0.012135090787789177,07
07064,Oxchuc,43350,21844,21506,0.007797001153402538,07
07063,Osumacinta,3792,1894,1898,-0.0010548523206751054,07
07058,Nicolás Ruíz,4317,2226,2091,0.03127171646977067,07
07057,Motozintla,69119,34033,35086,-0.015234595407919676,07
07056,Mitontic,11157,5497,5660,-0.014609662095545397,07
07054,Mazatán,26573,13165,13408,-0.009144620479434012,07
07053,Mazapa de Madero,7793,3868,3925,-0.0073142563839343,07
07052,Las Margaritas,111484,54787,56697,-0.0171325033188619,07
07051,Mapastepec,43913,21680,22233,-0.01259308177532849,07
07049,Larráinzar,20349,10035,10314,-0.013710747456877488,07
07047,Jitotol,18683,9448,9235,0.011400738639404806,07
07045,Ixtapangajoya,5478,2775,2703,0.013143483023001095,07
07044,Ixtapa,24517,12121,12396,-0.011216706774890893,07
07096,Tila,71432,35704,35728,-0.0003359838727741068,07
07085,Soyaló,9740,4887,4853,0.003490759753593429,07
07046,Jiquipilas,37818,18758,19060,-0.007985615315458248,07
07017,Cintalapa,78114,39239,38875,0.00465985610773997,07
07036,La Grandeza,7272,3649,3623,0.0035753575357535755,07
07011,Bella Vista,19281,9522,9759,-0.012291893573984752,07
07078,San Cristóbal de las Casas,185917,88996,96921,-0.042626548406009136,07
27004,Centro,640359,311619,328740,-0.02673656495809382,27
27013,Nacajuca,115066,56593,58473,-0.016338449237828723,27
27008,Huimanguillo,179285,88749,90536,-0.009967370387929832,27
27007,Emiliano Zapata,29518,14174,15344,-0.039636831763669625,27
27011,Jonuta,29511,14812,14699,0.0038290806817796756,27
27014,Paraíso,86620,42887,43733,-0.009766797506349572,27
27002,Cárdenas,248481,122234,126247,-0.016150128178814477,27
27006,Cunduacán,126416,62368,64048,-0.0132894570307556,27
27010,Jalpa de Méndez,83356,41362,41994,-0.00758193771294208,27
27005,Comalcalco,192802,95084,97718,-0.013661684007427309,27
27017,Tenosique,58960,28810,30150,-0.022727272727272728,27
27016,Teapa,53555,26314,27241,-0.017309308187844274,27
27009,Jalapa,36391,18283,18108,0.004808881316809101,27
27003,Centla,102110,50925,51185,-0.0025462736264812457,27
27001,Balancán,56739,28318,28421,-0.0018153298436701386,27
27015,Tacotalpa,46302,23006,23296,-0.006263228370264783,27
27012,Macuspana,153132,75220,77912,-0.017579604524201344,27
20453,Santiago Astata,3915,1941,1974,-0.00842911877394636,20
20413,Santa María Huatulco,38629,18726,19903,-0.030469336508840508,20
20334,Villa de Tututepec de Melchor Ocampo,43913,21372,22541,-0.0266208184364539,20
20102,San Andrés Zautla,4405,2135,2270,-0.03064699205448354,20
20427,Santa María Petapa,15387,7439,7948,-0.03307987261974394,20
20010,El Barrio de la Soledad,13608,6557,7051,-0.03630217519106408,20
20305,San Pedro Comitancillo,3944,1867,2077,-0.053245436105476676,20
20005,Asunción Ixtaltepec,14751,7296,7455,-0.01077893024201749,20
20025,Chahuites,11105,5498,5607,-0.009815398469158037,20
20075,Reforma de Pineda,2671,1310,1361,-0.019093972295020592,20
20141,San Francisco del Mar,7232,3659,3573,0.011891592920353982,20
20143,San Francisco Ixhuatán,8959,4429,4530,-0.011273579640584886,20
20043,Heroica Ciudad de Juchitán de Zaragoza,93038,45210,47828,-0.028139039962165997,20
20557,Unión Hidalgo,13970,6749,7221,-0.03378668575518969,20
20071,Pluma Hidalgo,3060,1503,1557,-0.01764705882352941,20
20012,Candelaria Loxicha,9860,4730,5130,-0.04056795131845842,20
20401,Santa María Colotepec,22562,11104,11458,-0.01569009839553231,20
20318,San Pedro Mixtepec -Dto. 22 -,42860,20826,22034,-0.028184787680821277,20
20057,Matías Romero Avendaño,38019,18198,19821,-0.04268918172492701,20
20103,San Antonino Castillo Velasco,5651,2690,2961,-0.0479561139621306,20
20360,Santa Ana Zegache,3592,1684,1908,-0.062360801781737196,20
20452,Santiago Apóstol,4220,1879,2341,-0.109478672985782,20
20087,San Agustín Yatareni,4075,1916,2159,-0.059631901840490796,20
20072,San José del Progreso,6579,3168,3411,-0.036935704514363885,20
20301,San Pedro Apóstol,1544,708,836,-0.08290155440414508,20
20068,Ocotlán de Morelos,21341,10208,11133,-0.04334379832247786,20
20132,San Dionisio Ocotlán,1245,609,636,-0.021686746987951807,20
20243,San Martín Tilcajete,1742,780,962,-0.1044776119402985,20
20315,San Pedro Mártir,1711,743,968,-0.1315020455873758,20
20530,Santo Tomás Jalieza,3385,1605,1780,-0.051698670605613,20
20546,Teotitlán del Valle,5638,2657,2981,-0.05746718694572543,20
20550,San Jerónimo Tlacochahuaya,5076,2368,2708,-0.06698187549251379,20
20145,San Francisco Lachigoló,3474,1697,1777,-0.023028209556706966,20
20067,Oaxaca de Juárez,263357,122446,140911,-0.07011395178408017,20
20091,San Andrés Huayápam,4879,2296,2583,-0.058823529411764705,20
20553,Tlalixtac de Cabrera,9417,4453,4964,-0.05426356589147287,20
20483,Santiago Suchilquitongo,9542,4555,4987,-0.0452735275623559,20
20077,Reyes Etla,3568,1700,1868,-0.04708520179372197,20
20045,Magdalena Apasco,7522,3576,3946,-0.049189045466631214,20
20193,San Juan del Estado,2546,1207,1339,-0.051846032992930086,20
20338,Villa de Etla,9280,4426,4854,-0.046120689655172416,20
20294,San Pablo Huitzo,6307,2995,3312,-0.050261614079594105,20
20277,Villa Sola de Vega,12525,6176,6349,-0.013812375249500998,20
20155,San Ildefonso Sola,940,470,470,0.0,20
20487,Santiago Tenango,1945,973,972,0.0005141388174807198,20
20494,Santiago Tlazoyaltepec,4894,2244,2650,-0.08295872496935022,20
20511,Santo Domingo Nuxaá,3610,1742,1868,-0.034903047091412745,20
20531,Santo Tomás Mazaltepec,2333,1094,1239,-0.062151735962280324,20
20535,San Vicente Lachixío,2976,1364,1612,-0.08333333333333333,20
20569,Santa Inés de Zaragoza,1707,804,903,-0.05799648506151142,20
20048,Magdalena Mixtepec,1304,642,662,-0.015337423312883436,20
20092,San Andrés Ixtlahuaca,1439,664,775,-0.07713690062543432,20
20094,San Andrés Nuxiño,1898,897,1001,-0.0547945205479452,20
20049,Magdalena Ocotlán,1141,546,595,-0.04294478527607362,20
20051,Magdalena Teitipac,4368,2059,2309,-0.05723443223443223,20
20069,La Pe,2446,1162,1284,-0.04987735077677841,20
20078,Rojas de Cuauhtémoc,1092,515,577,-0.056776556776556776,20
20083,San Agustín de las Juntas,8089,3956,4133,-0.021881567560885152,20
20084,San Agustín Etla,3893,1844,2049,-0.05265861803236579,20
20112,San Baltazar Chichicápam,2439,1132,1307,-0.07175071750717507,20
20118,San Bartolomé Quialana,2470,1026,1444,-0.16923076923076924,20
20162,San Jerónimo Taviche,1848,869,979,-0.05952380952380952,20
20178,San Juan Bautista Guelache,6287,2975,3312,-0.053602672180690314,20
20191,San Juan Chicomezúchil,320,147,173,-0.08125,20
20197,San Juan Guelavía,3047,1483,1564,-0.026583524778470626,20
20219,San Juan Teitipac,2565,1232,1333,-0.039376218323586745,20
20227,San Lorenzo Cacaotepec,13704,6548,7156,-0.044366608289550497,20
20233,San Lucas Quiaviní,1745,720,1025,-0.17478510028653296,20
20238,San Martín de los Cansecos,816,403,413,-0.012254901960784314,20
20247,Capulálpam de Méndez,1467,662,805,-0.09747784594410361,20
20262,San Miguel Amatlán,1043,508,535,-0.02588686481303931,20
20267,San Miguel del Río,294,148,146,0.006802721088435374,20
20284,San Miguel Tilquiápam,3160,1385,1775,-0.12341772151898735,20
20293,San Pablo Etla,15535,7430,8105,-0.04345027357579659,20
20295,San Pablo Huixtepec,9025,4256,4769,-0.056842105263157895,20
20310,San Pedro Ixtlahuaca,6822,3322,3500,-0.02609205511580182,20
20328,San Pedro Taviche,1173,569,604,-0.029838022165387893,20
20343,San Sebastián Abasolo,1849,882,967,-0.04597079502433748,20
20349,San Sebastián Teitipac,1976,906,1070,-0.08299595141700405,20
20107,San Antonio de la Cal,21456,10112,11344,-0.05741983594332588,20
20356,Santa Ana del Valle,1993,966,1027,-0.030607124937280482,20
20358,Santa Ana Tlapacoyan,1854,875,979,-0.05609492988133765,20
20363,Santa Catarina Ixtepeji,2633,1267,1366,-0.037599696164071404,20
20365,Santa Catarina Lachatao,1307,636,671,-0.026778882938026015,20
20368,Santa Catarina Minas,1816,889,927,-0.02092511013215859,20
20369,Santa Catarina Quiané,1847,887,960,-0.03952355170546833,20
20378,Santa Cruz Mixtepec,3615,1720,1895,-0.048409405255878286,20
20380,Santa Cruz Papalutla,1972,950,1022,-0.036511156186612576,20
20385,Santa Cruz Xoxocotlán,77833,36822,41011,-0.0538203589737001,20
20387,Santa Gertrudis,2858,1368,1490,-0.042687193841847444,20
20388,Santa Inés del Monte,2535,1233,1302,-0.027218934911242602,20
20393,Santa Lucía Ocotlán,3604,1615,1989,-0.10377358490566038,20
20399,Santa María Atzompa,27465,13029,14436,-0.05122883670125614,20
20403,Santa María Coyotepec,2772,1316,1456,-0.050505050505050504,20
20419,Santa María Jaltianguis,575,257,318,-0.10608695652173913,20
20443,Santa María Yavesía,448,200,248,-0.10714285714285714,20
20449,Santa María Zoquitlán,3359,1666,1693,-0.008038106579339089,20
20475,Santiago Matatlán,9653,4547,5106,-0.057909458199523464,20
20496,Santiago Xiacuí,2171,1023,1148,-0.05757715338553662,20
20504,Nuevo Zoquiápam,1652,788,864,-0.04600484261501211,20
20519,Santo Domingo Tomaltepec,2790,1367,1423,-0.02007168458781362,20
20539,Soledad Etla,5025,2431,2594,-0.032437810945273635,20
20544,Teococuilco de Marcos Pérez,1106,497,609,-0.10126582278481013,20
20555,Trinidad Zaachila,2653,1246,1407,-0.06068601583113457,20
20560,Villa Díaz Ordaz,6174,2797,3377,-0.09394233884029803,20
20561,Yaxe,2683,1269,1414,-0.0540439806187104,20
20565,Villa de Zaachila,34101,16240,17861,-0.04753526289551626,20
20420,Santa María Lachixío,1680,776,904,-0.0761904761904762,20
20426,Santa María Peñoles,7865,3799,4066,-0.03394787031150667,20
20104,San Antonino el Alto,2508,1228,1280,-0.02073365231259968,20
20108,San Antonio Huitepec,4289,2012,2277,-0.06178596409419445,20
20217,San Juan Tamazola,3446,1678,1768,-0.0261172373766686,20
20241,San Martín Lachilá,1084,480,604,-0.11439114391143912,20
20271,San Miguel Mixtepec,3245,1571,1674,-0.03174114021571649,20
20273,San Miguel Peras,3497,1672,1825,-0.04375178724621104,20
20013,Ciénega de Zimatlán,2785,1319,1466,-0.05278276481149013,20
20017,La Compañía,3302,1557,1745,-0.05693519079345851,20
20023,Cuilápam de Guerrero,18428,8824,9604,-0.042326893857173864,20
20033,Guadalupe Etla,2433,1150,1283,-0.054665022605836416,20
20123,San Bernardo Mixtepec,2705,1296,1409,-0.04177449168207024,20
20135,San Felipe Tejalápam,7187,3419,3768,-0.048559899819117854,20
20150,San Francisco Telixtlahuaca,11893,5694,6199,-0.04246195240898007,20
20161,San Jerónimo Sosola,2559,1205,1354,-0.05822586948026573,20
20398,Ayoquezco de Aldama,4406,2053,2353,-0.06808896958692692,20
20028,Heroica Ciudad de Ejutla de Crespo,19679,9233,10446,-0.061639310940596576,20
20409,Santa María del Tule,8165,3754,4411,-0.08046540110226577,20
20059,Miahuatlán de Porfirio Díaz,41387,19792,21595,-0.04356440428153768,20
20154,San Ildefonso Amatlán,2393,1124,1269,-0.060593397409109906,20
20167,San José del Peñasco,2094,1038,1056,-0.008595988538681949,20
20209,San Juan Mixtepec -Dto. 26 -,711,277,434,-0.22081575246132207,20
20254,San Mateo Río Hondo,3308,1605,1703,-0.02962515114873035,20
20319,San Pedro Mixtepec -Dto. 26 -,1099,518,581,-0.05732484076433121,20
20347,San Sebastián Río Hondo,3664,1803,1861,-0.015829694323144104,20
20314,San Pedro Juchatengo,1693,807,886,-0.04666272888363851,20
20149,San Francisco Sola,1509,726,783,-0.03777335984095427,20
20096,San Andrés Sinaxtla,772,364,408,-0.05699481865284974,20
20215,San Juan Sayultepec,764,351,413,-0.08115183246073299,20
20562,Magdalena Yodocono de Porfirio Díaz,1458,691,767,-0.05212620027434842,20
20147,San Francisco Nuxaño,378,195,183,0.031746031746031744,20
20230,San Lorenzo Victoria,1007,491,516,-0.024826216484607744,20
20164,San Jorge Nuchita,3215,1486,1729,-0.07558320373250389,20
20548,Tepelmeme Villa de Morelos,1734,796,938,-0.08189158016147635,20
20018,Concepción Buenavista,834,397,437,-0.047961630695443645,20
20021,Cosolapa,14667,7057,7610,-0.037703688552532894,20
20327,San Pedro Tapanatepec,13992,6870,7122,-0.018010291595197257,20
20211,San Juan Ozolotepec,3168,1582,1586,-0.0012626262626262627,20
20474,Santiago Llano Grande,3260,1609,1651,-0.012883435582822086,20
20476,Santiago Miltepec,409,197,212,-0.03667481662591687,20
20477,Santiago Minas,1430,701,729,-0.019580419580419582,20
20478,Santiago Nacaltepec,1913,919,994,-0.03920543648719289,20
20479,Santiago Nejapilla,219,118,101,0.0776255707762557,20
20480,Santiago Nundiche,967,469,498,-0.02998965873836608,20
20481,Santiago Nuyoó,1966,926,1040,-0.05798575788402848,20
20482,Santiago Pinotepa Nacional,50309,24328,25981,-0.032856944085551294,20
20484,Santiago Tamazola,4207,1922,2285,-0.08628476348942239,20
20485,Santiago Tapextla,3031,1539,1492,0.015506433520290333,20
20486,Villa Tejúpam de la Unión,2469,1194,1275,-0.032806804374240585,20
20488,Santiago Tepetlapa,131,62,69,-0.05343511450381679,20
20489,Santiago Tetepec,4953,2403,2550,-0.029678982434887948,20
20490,Santiago Texcalcingo,3076,1473,1603,-0.04226267880364109,20
20491,Santiago Textitlán,4170,2048,2122,-0.017745803357314148,20
20492,Santiago Tilantongo,3210,1495,1715,-0.06853582554517133,20
20493,Santiago Tillo,553,258,295,-0.06690777576853527,20
20497,Santiago Yaitepec,4122,1893,2229,-0.08151382823871907,20
20499,Santiago Yolomécatl,2021,932,1089,-0.0776843146956952,20
20500,Santiago Yosondúa,7883,3723,4160,-0.055435747811746795,20
20501,Santiago Yucuyachi,940,446,494,-0.05106382978723404,20
20507,Santo Domingo Armenta,3224,1601,1623,-0.006823821339950372,20
20510,Santo Domingo Ixcatlán,877,405,472,-0.07639680729760548,20
20516,Santo Domingo Teojomulco,4571,2198,2373,-0.03828483920367534,20
20520,Santo Domingo Tonalá,7153,3339,3814,-0.06640570390046134,20
20521,Santo Domingo Tonaltepec,276,111,165,-0.1956521739130435,20
20523,Santo Domingo Yanhuitlán,1609,760,849,-0.05531385954008701,20
20524,Santo Domingo Yodohino,369,173,196,-0.06233062330623306,20
20526,Santos Reyes Nopala,15986,7759,8227,-0.029275616164143627,20
20527,Santos Reyes Pápalo,2829,1375,1454,-0.027925061859314246,20
20528,Santos Reyes Tepejillo,1213,520,693,-0.14262159934047816,20
20529,Santos Reyes Yucuná,1332,658,674,-0.012012012012012012,20
20532,Santo Tomás Ocotepec,4076,1900,2176,-0.06771344455348381,20
20536,San Vicente Nuñú,493,225,268,-0.0872210953346856,20
20540,Villa de Tamazulápam del Progreso,7059,3288,3771,-0.06842328941776456,20
20543,Tataltepec de Valdés,5561,2709,2852,-0.025714799496493437,20
20545,Teotitlán de Flores Magón,8966,4275,4691,-0.04639750167298684,20
20547,Teotongo,951,433,518,-0.08937960042060988,20
20549,Tezoatlán de Segura y Luna,11319,5158,6161,-0.08861206820390494,20
20552,Tlacotepec Plumas,510,240,270,-0.058823529411764705,20
20556,La Trinidad Vista Hermosa,249,110,139,-0.11646586345381527,20
20558,Valerio Trujano,1543,685,858,-0.11211924821775761,20
20564,Yutanduchi de Guerrero,1292,617,675,-0.04489164086687306,20
20566,San Mateo Yucutindó,3034,1473,1561,-0.02900461437046803,20
20567,Zapotitlán Lagunas,3133,1436,1697,-0.08330673475901691,20
20568,Zapotitlán Palmas,1514,669,845,-0.11624834874504623,20
20004,Asunción Cuyotepeji,1012,469,543,-0.07312252964426877,20
20011,Calihualá,1220,595,625,-0.02459016393442623,20
20016,Coicoyán de las Flores,8531,3990,4541,-0.0645879732739421,20
20022,Cosoltepec,866,394,472,-0.09006928406466513,20
20024,Cuyamecalco Villa de Zaragoza,3846,1949,1897,0.013520540821632865,20
20026,Chalcatongo de Hidalgo,8481,3923,4558,-0.07487324607947177,20
20029,Eloxochitlán de Flores Magón,4263,2024,2239,-0.05043396669012432,20
20032,Fresnillo de Trujano,1033,489,544,-0.05324298160696999,20
20034,Guadalupe de Ramírez,1425,689,736,-0.03298245614035088,20
20037,Mesones Hidalgo,4402,1984,2418,-0.09859154929577464,20
20046,Magdalena Jaltepec,3313,1540,1773,-0.07032900694234832,20
20047,Santa Magdalena Jicotlán,93,40,53,-0.13978494623655913,20
20050,Magdalena Peñasco,3778,1755,2023,-0.07093700370566437,20
20054,Magdalena Zahuatlán,409,194,215,-0.05134474327628362,20
20055,Mariscala de Juárez,3530,1690,1840,-0.042492917847025496,20
20056,Mártires de Tacubaya,1451,705,746,-0.028256374913852515,20
20058,Mazatlán Villa de Flores,13435,6634,6801,-0.01243021957573502,20
20065,Ixpantepec Nieves,1182,526,656,-0.10998307952622674,20
20070,Pinotepa de Don Luis,6629,3248,3381,-0.02006335797254488,20
20076,La Reforma,3331,1574,1757,-0.05493845691984389,20
20081,San Agustín Atenango,1914,897,1017,-0.06269592476489028,20
20082,San Agustín Chayuco,3952,1846,2106,-0.06578947368421052,20
20086,San Agustín Tlacotepec,874,368,506,-0.15789473684210525,20
20088,San Andrés Cabecera Nueva,2851,1396,1455,-0.020694493160294633,20
20089,San Andrés Dinicuiti,2152,1034,1118,-0.03903345724907063,20
20090,San Andrés Huaxpaltepec,5867,2850,3017,-0.028464291801602183,20
20093,San Andrés Lagunas,505,239,266,-0.053465346534653464,20
20099,San Andrés Tepetlapa,475,225,250,-0.05263157894736842,20
20101,San Andrés Zabache,726,317,409,-0.12672176308539945,20
20052,Magdalena Tequisistlán,6182,3026,3156,-0.021028793270786154,20
20053,Magdalena Tlacotepec,1221,581,640,-0.04832104832104832,20
20060,Mixistlán de la Reforma,2770,1292,1478,-0.06714801444043321,20
20061,Monjas,2568,1166,1402,-0.09190031152647975,20
20066,Santiago Niltepec,5353,2655,2698,-0.00803287875957407,20
20074,Santa Catarina Quioquitani,505,245,260,-0.0297029702970297,20
20079,Salina Cruz,82371,39508,42863,-0.04073035412948732,20
20080,San Agustín Amatengo,1312,614,698,-0.06402439024390244,20
20085,San Agustín Loxicha,22565,11108,11457,-0.015466430312430756,20
20095,San Andrés Paxtlán,3990,1970,2020,-0.012531328320802004,20
20097,San Andrés Solaga,1740,833,907,-0.04252873563218391,20
20098,San Andrés Teotilálpam,4427,2106,2321,-0.04856562005873052,20
20100,San Andrés Yaá,497,228,269,-0.08249496981891348,20
20113,San Baltazar Loxicha,2832,1381,1451,-0.024717514124293787,20
20114,San Baltazar Yatzachi el Bajo,677,314,363,-0.0723781388478582,20
20116,San Bartolomé Ayautla,4052,1941,2111,-0.041954590325765054,20
20117,San Bartolomé Loxicha,2422,1173,1249,-0.03137902559867878,20
20120,San Bartolomé Zoogocho,368,160,208,-0.13043478260869565,20
20122,San Bartolo Yautepec,677,333,344,-0.01624815361890694,20
20125,San Carlos Yautepec,11813,5902,5911,-0.000761872513332769,20
20126,San Cristóbal Amatlán,5024,2365,2659,-0.05851910828025478,20
20130,San Dionisio del Mar,5098,2582,2516,0.012946253432718713,20
20131,San Dionisio Ocotepec,10500,4894,5606,-0.0678095238095238,20
20134,San Felipe Jalapa de Díaz,26838,12997,13841,-0.031447946940904685,20
20136,San Felipe Usila,11575,5565,6010,-0.03844492440604751,20
20146,San Francisco Logueche,2666,1256,1410,-0.05776444111027757,20
20159,San Jerónimo Coatlán,5449,2636,2813,-0.032483024408148285,20
20166,San José Chiltepec,11019,5279,5740,-0.04183682729830293,20
20169,San José Independencia,3684,1779,1905,-0.03420195439739414,20
20170,San José Lachiguiri,3849,1757,2092,-0.0870355936606911,20
20171,San José Tenango,18478,8929,9549,-0.033553414871739365,20
20173,San Juan Atepec,1517,722,795,-0.04812129202373105,20
20175,San Juan Bautista Atatlahuca,1724,833,891,-0.033642691415313224,20
20179,San Juan Bautista Jayacatlán,1462,736,726,0.006839945280437756,20
20182,San Juan Bautista Tlacoatzintepec,2292,1088,1204,-0.0506108202443281,20
20184,San Juan Bautista Tuxtepec,155766,74788,80978,-0.03973909582322201,20
20187,San Juan Coatzóspam,2535,1275,1260,0.005917159763313609,20
20189,San Juan Comaltepec,2517,1207,1310,-0.04092173222089789,20
20190,San Juan Cotzocón,22356,10895,11461,-0.025317588119520486,20
20194,San Juan del Río,1231,557,674,-0.0950446791226645,20
20196,San Juan Evangelista Analco,404,197,207,-0.024752475247524754,20
20200,San Juan Juquila Mixes,3924,1841,2083,-0.06167176350662589,20
20201,San Juan Juquila Vijanos,1832,871,961,-0.04912663755458515,20
20203,San Juan Lachigalla,3285,1580,1705,-0.0380517503805175,20
20204,San Juan Lajarcia,715,324,391,-0.0937062937062937,20
20207,San Juan Mazatlán,17100,8432,8668,-0.013801169590643274,20
20212,San Juan Petlapa,2807,1344,1463,-0.04239401496259352,20
20214,San Juan Quiotepec,2313,1153,1160,-0.0030263726761781237,20
20216,San Juan Tabaá,1331,633,698,-0.048835462058602556,20
20220,San Juan Tepeuxila,2773,1429,1344,0.030652722683014784,20
20222,San Juan Yaeé,1530,718,812,-0.06143790849673202,20
20223,San Juan Yatzona,452,195,257,-0.13716814159292035,20
20226,San Lorenzo Albarradas,2708,1359,1349,0.003692762186115214,20
20231,San Lucas Camotlán,3026,1493,1533,-0.013218770654329148,20
20232,San Lucas Ojitlán,21514,10395,11119,-0.03365250534535651,20
20235,San Luis Amatlán,3624,1657,1967,-0.08554083885209714,20
20236,San Marcial Ozolotepec,1525,723,802,-0.05180327868852459,20
20246,San Mateo Cajonos,620,280,340,-0.0967741935483871,20
20248,San Mateo del Mar,14252,7203,7049,0.010805500982318271,20
20253,San Mateo Piñas,2226,1110,1116,-0.0026954177897574125,20
20257,San Melchor Betaza,1091,503,588,-0.07791017415215398,20
20260,San Miguel Aloápam,2488,1175,1313,-0.05546623794212219,20
20263,San Miguel Coatlán,3483,1638,1845,-0.059431524547803614,20
20265,San Miguel Chimalapa,6608,3397,3211,0.028147699757869248,20
20266,San Miguel del Puerto,8481,4210,4271,-0.007192548048579177,20
20268,San Miguel Ejutla,916,418,498,-0.08733624454148471,20
20275,San Miguel Quetzaltepec,7293,3652,3641,0.0015082956259426848,20
20276,San Miguel Santa Flor,801,398,403,-0.006242197253433208,20
20278,San Miguel Soyaltepec,36564,17715,18849,-0.031014112241549065,20
20279,San Miguel Suchixtepec,2911,1402,1509,-0.03675712813466163,20
20280,Villa Talea de Castro,2394,1152,1242,-0.03759398496240601,20
20282,San Miguel Tenango,794,410,384,0.0327455919395466,20
20288,San Miguel Yotao,611,297,314,-0.027823240589198037,20
20289,San Nicolás,1143,519,624,-0.09186351706036745,20
20291,San Pablo Coatlán,4167,2029,2138,-0.026157907367410606,20
20296,San Pablo Macuiltianguis,929,440,489,-0.0527448869752422,20
20298,San Pablo Villa de Mitla,11825,5614,6211,-0.050486257928118394,20
20299,San Pablo Yaganiza,1108,518,590,-0.06498194945848375,20
20306,San Pedro el Alto,3903,1904,1999,-0.02434025108890597,20
20307,San Pedro Huamelula,9594,4795,4799,-0.0004169272461955389,20
20308,San Pedro Huilotepec,2839,1397,1442,-0.01585065163790067,20
20309,San Pedro Ixcatlán,10371,5113,5258,-0.013981293992864718,20
20316,San Pedro Mártir Quiechapa,753,342,411,-0.09163346613545817,20
20323,San Pedro Ocotepec,2135,1030,1105,-0.0351288056206089,20
20324,San Pedro Pochutla,43860,21514,22346,-0.018969448244414044,20
20325,San Pedro Quiatoni,10491,5052,5439,-0.036888761795824995,20
20326,San Pedro Sochiápam,4957,2440,2517,-0.015533588864232398,20
20330,San Pedro Teutila,4277,2094,2183,-0.020808978255786766,20
20333,San Pedro Totolápam,2603,1227,1376,-0.05724164425662697,20
20335,San Pedro Yaneri,1002,485,517,-0.031936127744510975,20
20336,San Pedro Yólox,2267,1059,1208,-0.06572562858403176,20
20344,San Sebastián Coatlán,2613,1261,1352,-0.03482587064676617,20
20351,San Simón Almolongas,2623,1214,1409,-0.07434235608082349,20
20124,San Blas Atempa,17094,8525,8569,-0.002574002574002574,20
20139,San Francisco Chapulapa,2136,1022,1114,-0.04307116104868914,20
20353,Santa Ana,1978,957,1021,-0.032355915065722954,20
20355,Santa Ana Cuauhtémoc,738,347,391,-0.05962059620596206,20
20357,Santa Ana Tavela,908,442,466,-0.02643171806167401,20
20359,Santa Ana Yareni,809,347,462,-0.14215080346106304,20
20361,Santa Catalina Quierí,922,415,507,-0.09978308026030369,20
20362,Santa Catarina Cuixtla,1496,673,823,-0.10026737967914438,20
20366,Santa Catarina Loxicha,3986,1985,2001,-0.004014049172102358,20
20384,Santa Cruz Xitla,4514,2153,2361,-0.0460788657509969,20
20391,Santa Lucía Miahuatlán,3356,1634,1722,-0.026221692491060787,20
20394,Santa María Alotepec,2778,1381,1397,-0.005759539236861051,20
20406,Santa María Chilchotla,20584,10098,10486,-0.018849591916051303,20
20407,Santa María Chimalapa,8506,4256,4250,0.0007053844345168116,20
20410,Santa María Ecatepec,3461,1703,1758,-0.015891360878358855,20
20412,Santa María Guienagati,3286,1639,1647,-0.002434570906877663,20
20417,Santa María Jacatepec,9240,4380,4860,-0.05194805194805195,20
20418,Santa María Jalapa del Marqués,11888,5707,6181,-0.0398721399730821,20
20421,Santa María Mixtequilla,4442,2158,2284,-0.028365601080594327,20
20424,Santa María Ozolotepec,3992,1915,2077,-0.0405811623246493,20
20425,Santa María Pápalo,2209,1104,1105,-0.0004526935264825713,20
20428,Santa María Quiegolani,1770,886,884,0.0011299435028248588,20
20432,Santa María Temaxcalapa,968,465,503,-0.03925619834710744,20
20435,Santa María Tepantlali,3505,1714,1791,-0.021968616262482168,20
20437,Santa María Tlahuitoltepec,9663,4680,4983,-0.03135672151505744,20
20438,Santa María Tlalixtac,1754,841,913,-0.04104903078677309,20
20439,Santa María Tonameca,24318,12000,12318,-0.01307673328398717,20
20440,Santa María Totolapilla,896,425,471,-0.05133928571428571,20
20441,Santa María Xadani,7781,3929,3852,0.009895900269888189,20
20442,Santa María Yalina,354,162,192,-0.0847457627118644,20
20454,Santiago Atitlán,3180,1618,1562,0.01761006289308176,20
20457,Santiago Camotlán,3395,1704,1691,0.003829160530191458,20
20458,Santiago Comaltepec,1115,528,587,-0.05291479820627803,20
20465,Santiago Ixcuintepec,1568,773,795,-0.01403061224489796,20
20468,Santiago Jocotepec,13568,6682,6886,-0.015035377358490566,20
20471,Santiago Lalopa,496,225,271,-0.09274193548387097,20
20472,Santiago Laollaga,3198,1594,1604,-0.0031269543464665416,20
20473,Santiago Laxopa,1394,660,734,-0.05308464849354376,20
20495,Santiago Xanica,2884,1428,1456,-0.009708737864077669,20
20498,Santiago Yaveo,6665,3326,3339,-0.0019504876219054764,20
20502,Santiago Zacatepec,5515,2730,2785,-0.009972801450589302,20
20503,Santiago Zoochila,374,175,199,-0.06417112299465241,20
20505,Santo Domingo Ingenio,7554,3781,3773,0.0010590415673815197,20
20506,Santo Domingo Albarradas,782,361,421,-0.07672634271099744,20
20508,Santo Domingo Chihuitán,1521,754,767,-0.008547008547008548,20
20509,Santo Domingo de Morelos,10547,5065,5482,-0.03953730918744667,20
20512,Santo Domingo Ozolotepec,913,432,481,-0.05366922234392114,20
20513,Santo Domingo Petapa,8394,4192,4202,-0.0011913271384322134,20
20514,Santo Domingo Roayaga,997,472,525,-0.05315947843530592,20
20517,Santo Domingo Tepuxtepec,5194,2454,2740,-0.05506353484790143,20
20522,Santo Domingo Xagacía,1213,564,649,-0.07007419620774938,20
20525,Santo Domingo Zanatepec,11218,5541,5677,-0.01212337315029417,20
20533,Santo Tomás Tamazulapan,2191,1052,1139,-0.03970789593792789,20
20534,San Vicente Coatlán,3964,1839,2125,-0.07214934409687185,20
20538,Sitio de Xitlapehua,705,339,366,-0.03829787234042553,20
20541,Tanetze de Zaragoza,1707,825,882,-0.033391915641476276,20
20554,Totontepec Villa de Morelos,5598,2685,2913,-0.04072883172561629,20
20559,San Juan Bautista Valle Nacional,22446,10688,11758,-0.04766996346787846,20
20563,Yogana,1308,602,706,-0.07951070336391437,20
20372,Santa Catarina Yosonotú,1886,845,1041,-0.10392364793213149,20
20373,Santa Catarina Zapoquila,448,214,234,-0.044642857142857144,20
20374,Santa Cruz Acatepec,1470,710,760,-0.034013605442176874,20
20376,Santa Cruz de Bravo,364,177,187,-0.027472527472527472,20
20377,Santa Cruz Itundujia,10975,5278,5697,-0.03817767653758542,20
20379,Santa Cruz Nundaco,2958,1359,1599,-0.08113590263691683,20
20381,Santa Cruz Tacache de Mina,2606,1235,1371,-0.052187260168841135,20
20382,Santa Cruz Tacahua,1170,551,619,-0.05811965811965812,20
20383,Santa Cruz Tayata,608,294,314,-0.03289473684210526,20
20386,Santa Cruz Zenzontepec,17897,8669,9228,-0.031234285075711014,20
20392,Santa Lucía Monteverde,6678,3184,3494,-0.04642108415693321,20
20395,Santa María Apazco,1898,870,1028,-0.08324552160168598,20
20396,Santa María la Asunción,3252,1440,1812,-0.11439114391143912,20
20397,Heroica Ciudad de Tlaxiaco,38453,17987,20466,-0.06446831196525629,20
20400,Santa María Camotlán,1632,750,882,-0.08088235294117647,20
20402,Santa María Cortijo,1083,516,567,-0.04709141274238227,20
20404,Santa María Chachoápam,766,355,411,-0.0731070496083551,20
20405,Villa de Chilapa de Díaz,1932,844,1088,-0.12629399585921325,20
20408,Santa María del Rosario,480,249,231,0.0375,20
20414,Santa María Huazolotitlán,10794,5277,5517,-0.022234574763757644,20
20415,Santa María Ipalapa,4888,2290,2598,-0.0630114566284779,20
20416,Santa María Ixcatlán,516,243,273,-0.05813953488372093,20
20422,Santa María Nativitas,681,308,373,-0.09544787077826726,20
20423,Santa María Nduayaco,550,280,270,0.01818181818181818,20
20429,Santa María Sola,1524,719,805,-0.05643044619422572,20
20430,Santa María Tataltepec,253,122,131,-0.03557312252964427,20
20431,Santa María Tecomavaca,1774,847,927,-0.04509582863585118,20
20433,Santa María Temaxcaltepec,2595,1204,1391,-0.0720616570327553,20
20434,Santa María Teopoxco,4651,2208,2443,-0.05052676843689529,20
20436,Santa María Texcatitlán,1113,539,574,-0.031446540880503145,20
20444,Santa María Yolotepec,461,228,233,-0.010845986984815618,20
20445,Santa María Yosoyúa,1642,805,837,-0.0194884287454324,20
20446,Santa María Yucuhiti,6551,3119,3432,-0.04777896504350481,20
20447,Santa María Zacatepec,15076,7021,8055,-0.06858583178561953,20
20448,Santa María Zaniza,2009,964,1045,-0.04031856645097063,20
20450,Santiago Amoltepec,12313,5930,6383,-0.03679038414683668,20
20451,Santiago Apoala,1053,495,558,-0.05982905982905983,20
20456,Santiago Cacaloxtepec,1686,808,878,-0.04151838671411625,20
20459,Santiago Chazumba,4479,2040,2439,-0.08908238446081715,20
20461,Santiago del Río,614,306,308,-0.003257328990228013,20
20462,Santiago Huajolotitlán,4350,1972,2378,-0.09333333333333334,20
20463,Santiago Huauclilla,663,317,346,-0.043740573152337855,20
20464,Santiago Ihuitlán Plumas,480,217,263,-0.09583333333333334,20
20466,Santiago Ixtayutla,11917,5749,6168,-0.03515985566837291,20
20467,Santiago Jamiltepec,18383,8815,9568,-0.040961758146113254,20
20469,Santiago Juxtlahuaca,32927,15475,17452,-0.06004191089379537,20
20237,San Marcos Arteaga,1557,719,838,-0.07642903018625562,20
20105,San Antonino Monte Verde,6650,3079,3571,-0.07398496240601504,20
20106,San Antonio Acutla,297,126,171,-0.15151515151515152,20
20109,San Antonio Nanahuatípam,1233,617,616,0.0008110300081103001,20
20110,San Antonio Sinicahua,1603,738,865,-0.0792264504054897,20
20208,San Juan Mixtepec -Dto. 08 -,7611,3572,4039,-0.061358559978977795,20
20210,San Juan Ñumí,6666,3196,3470,-0.0411041104110411,20
20213,San Juan Quiahije,3628,1702,1926,-0.06174200661521499,20
20218,San Juan Teita,607,291,316,-0.04118616144975288,20
20221,San Juan Teposcolula,1340,646,694,-0.03582089552238806,20
20224,San Juan Yucuita,684,314,370,-0.08187134502923976,20
20225,San Lorenzo,5955,2842,3113,-0.04550797649034425,20
20228,San Lorenzo Cuaunecuiltitla,771,404,367,0.04798962386511025,20
20229,San Lorenzo Texmelúcan,7048,3213,3835,-0.08825198637911465,20
20234,San Lucas Zoquiápam,7554,3653,3901,-0.03283028858882711,20
20239,San Martín Huamelúlpam,1077,489,588,-0.09192200557103064,20
20240,San Martín Itunyoso,2460,1077,1383,-0.12439024390243902,20
20242,San Martín Peras,11361,5473,5888,-0.03652847460610862,20
20244,San Martín Toxpalan,3669,1774,1895,-0.03297901335513764,20
20245,San Martín Zacatepec,1277,619,658,-0.030540328895849646,20
20249,San Mateo Yoloxochitlán,3475,1654,1821,-0.04805755395683453,20
20250,San Mateo Etlatongo,1181,565,616,-0.04318374259102455,20
20251,San Mateo Nejápam,1180,551,629,-0.06610169491525424,20
20252,San Mateo Peñasco,2116,973,1143,-0.08034026465028356,20
20255,San Mateo Sindihui,2086,993,1093,-0.04793863854266539,20
20256,San Mateo Tlapiltepec,234,106,128,-0.09401709401709402,20
20258,San Miguel Achiutla,744,348,396,-0.06451612903225806,20
20259,San Miguel Ahuehuetitlán,2465,1171,1294,-0.04989858012170385,20
20261,San Miguel Amatitlán,7244,3421,3823,-0.05549420209828824,20
20264,San Miguel Chicahua,2274,1016,1258,-0.10642040457343888,20
20269,San Miguel el Grande,4127,1904,2223,-0.07729585655439787,20
20270,San Miguel Huautla,1399,659,740,-0.057898498927805575,20
20272,San Miguel Panixtlahuaca,6161,2852,3309,-0.074176270086025,20
20274,San Miguel Piedras,1296,638,658,-0.015432098765432098,20
20281,San Miguel Tecomatlán,308,159,149,0.032467532467532464,20
20283,San Miguel Tequixtepec,1042,511,531,-0.019193857965451054,20
20285,San Miguel Tlacamama,3386,1654,1732,-0.02303603071470762,20
20286,San Miguel Tlacotepec,3220,1483,1737,-0.07888198757763976,20
20287,San Miguel Tulancingo,346,134,212,-0.2254335260115607,20
20290,San Nicolás Hidalgo,1012,463,549,-0.08498023715415019,20
20297,San Pablo Tijaltepec,2150,948,1202,-0.11813953488372093,20
20300,San Pedro Amuzgos,6468,3032,3436,-0.06246134817563389,20
20302,San Pedro Atoyac,4136,1953,2183,-0.05560928433268859,20
20304,San Pedro Coxcaltepec Cántaros,851,407,444,-0.043478260869565216,20
20311,San Pedro Jaltepetongo,458,216,242,-0.056768558951965066,20
20312,San Pedro Jicayán,11555,5544,6011,-0.04041540458675898,20
20313,San Pedro Jocotipac,834,377,457,-0.09592326139088729,20
20317,San Pedro Mártir Yucuxaco,1405,667,738,-0.050533807829181494,20
20320,San Pedro Molinos,723,338,385,-0.06500691562932227,20
20321,San Pedro Nopala,840,403,437,-0.04047619047619048,20
20322,San Pedro Ocopetatillo,884,408,476,-0.07692307692307693,20
20329,San Pedro Teozacoalco,1320,629,691,-0.04696969696969697,20
20331,San Pedro Tidaá,894,415,479,-0.07158836689038031,20
20332,San Pedro Topiltepec,406,199,207,-0.019704433497536946,20
20339,San Pedro y San Pablo Teposcolula,3989,1907,2082,-0.043870644271747306,20
20340,San Pedro y San Pablo Tequixtepec,1878,851,1027,-0.09371671991480299,20
20341,San Pedro Yucunama,232,99,133,-0.14655172413793102,20
20345,San Sebastián Ixcapa,3968,1954,2014,-0.015120967741935484,20
20346,San Sebastián Nicananduta,1449,624,825,-0.13871635610766045,20
20348,San Sebastián Tecomaxtlahuaca,8246,3929,4317,-0.0470531166626243,20
20352,San Simón Zahuatlán,3833,1903,1930,-0.007044090790503522,20
20354,Santa Ana Ateixtlahuaca,510,257,253,0.00784313725490196,20
20364,Santa Catarina Juquila,14710,7145,7565,-0.028552005438477225,20
20367,Santa Catarina Mechoacán,4543,2232,2311,-0.017389390270746204,20
20370,Santa Catarina Tayata,679,312,367,-0.08100147275405008,20
20371,Santa Catarina Ticuá,954,423,531,-0.11320754716981132,20
20001,Abejones,1084,483,601,-0.1088560885608856,20
20002,Acatlán de Pérez Figueroa,44885,21866,23019,-0.025687868998551855,20
20003,Asunción Cacalotepec,2495,1206,1289,-0.03326653306613227,20
20008,Asunción Tlacolulita,842,412,430,-0.021377672209026127,20
20009,Ayotzintepec,6720,3314,3406,-0.01369047619047619,20
20014,Ciudad Ixtepec,26450,12677,13773,-0.041436672967863894,20
20015,Coatecas Altas,4712,2221,2491,-0.05730050933786078,20
20019,Concepción Pápalo,3071,1537,1534,0.0009768804949527841,20
20027,Chiquihuitlán de Benito Juárez,2458,1157,1301,-0.05858421480878763,20
20030,El Espinal,8310,4031,4279,-0.029843561973525872,20
20038,Villa Hidalgo,2112,1000,1112,-0.05303030303030303,20
20040,Huautepec,5995,2824,3171,-0.05788156797331109,20
20041,Huautla de Jiménez,30004,13952,16052,-0.0699906679109452,20
20111,San Antonio Tepetlapa,4394,2111,2283,-0.03914428766499772,20
20119,San Bartolomé Yucuañe,399,163,236,-0.18295739348370926,20
20121,San Bartolo Soyaltepec,655,291,364,-0.11145038167938931,20
20127,San Cristóbal Amoltepec,1283,601,682,-0.06313328137178488,20
20129,San Cristóbal Suchixtlahuaca,334,161,173,-0.03592814371257485,20
20133,San Esteban Atatlahuca,3974,1938,2036,-0.024660291897332664,20
20137,San Francisco Cahuacuá,3427,1671,1756,-0.024803034724248614,20
20142,San Francisco Huehuetlán,1160,516,644,-0.1103448275862069,20
20144,San Francisco Jaltepetongo,1110,544,566,-0.01981981981981982,20
20151,San Francisco Teopan,394,205,189,0.04060913705583756,20
20152,San Francisco Tlapancingo,2152,981,1171,-0.08828996282527882,20
20153,San Gabriel Mixtepec,4733,2263,2470,-0.04373547432917811,20
20158,San Jacinto Tlacotepec,2231,1094,1137,-0.01927386822052891,20
20160,San Jerónimo Silacayoapilla,1449,710,739,-0.020013802622498276,20
20163,San Jerónimo Tecóatl,1606,769,837,-0.04234122042341221,20
20168,San José Estancia Grande,977,485,492,-0.007164790174002047,20
20172,San Juan Achiutla,430,213,217,-0.009302325581395349,20
20176,San Juan Bautista Coixtlahuaca,2808,1334,1474,-0.04985754985754986,20
20177,San Juan Bautista Cuicatlán,9441,4601,4840,-0.025315114924266496,20
20180,San Juan Bautista Lo de Soto,2325,1138,1187,-0.021075268817204302,20
20181,San Juan Bautista Suchitepec,417,187,230,-0.10311750599520383,20
20185,San Juan Cacahuatepec,8680,4216,4464,-0.02857142857142857,20
20186,San Juan Cieneguilla,605,294,311,-0.02809917355371901,20
20188,San Juan Colorado,9494,4583,4911,-0.034548135664630296,20
20195,San Juan Diuxi,1256,627,629,-0.0015923566878980893,20
20199,San Juan Ihualtepec,713,328,385,-0.07994389901823282,20
20202,San Juan Lachao,4531,2159,2372,-0.04700949017876849,20
20206,San Juan de los Cués,2357,1166,1191,-0.010606703436571913,20
20031,Tamazulápam del Espíritu Santo,7362,3434,3928,-0.06710133116001087,20
20337,San Pedro y San Pablo Ayutla,5602,2597,3005,-0.07283113173866476,20
20148,San Francisco Ozolotepec,1945,925,1020,-0.04884318766066838,20
20138,San Francisco Cajonos,460,217,243,-0.05652173913043478,20
20165,San José Ayuquila,1511,697,814,-0.07743216412971542,20
20455,Santiago Ayuquililla,2748,1284,1464,-0.06550218340611354,20
20518,Santo Domingo Tlatayápam,153,74,79,-0.032679738562091505,20
20140,San Francisco Chindúa,827,395,432,-0.044740024183796856,20
20156,San Ildefonso Villa Alta,3478,1691,1787,-0.027602070155261643,20
20128,San Cristóbal Lachirioag,1230,591,639,-0.03902439024390244,20
20542,Taniche,746,332,414,-0.10991957104557641,20
20470,Santiago Lachiguiri,4693,2302,2391,-0.018964415086298744,20
20205,San Juan Lalana,17398,8441,8957,-0.029658581446143233,20
20042,Ixtlán de Juárez,7674,3755,3919,-0.02137086265311441,20
20183,San Juan Bautista Tlachichilco,1447,681,766,-0.05874222529371113,20
20292,San Pablo Cuatro Venados,1388,640,748,-0.07780979827089338,20
20073,Putla Villa de Guerrero,31897,14982,16915,-0.060601310468069096,20
20039,Heroica Ciudad de Huajuapan de León,69839,32910,36929,-0.05754664299317001,20
20020,Constancia del Rosario,3860,1795,2065,-0.06994818652849741,20
20006,Asunción Nochixtlán,17820,8437,9383,-0.05308641975308642,20
20537,Silacayoápam,6747,3159,3588,-0.06358381502890173,20
20390,Santa Lucía del Camino,47356,22857,24499,-0.03467353661626826,20
20350,San Sebastián Tutla,16241,7515,8726,-0.0745643741148944,20
20515,Santo Domingo Tehuantepec,61872,30124,31748,-0.026247737264028962,20
20570,Zimatlán de Álvarez,19215,8935,10280,-0.06999739786625032,20
20551,Tlacolula de Matamoros,19625,9151,10474,-0.0674140127388535,20
20460,Santiago Choápam,5413,2620,2793,-0.031960096065028636,20
20198,San Juan Guichicovi,28142,13221,14921,-0.06040793120602658,20
20115,San Bartolo Coyotepec,8684,4141,4543,-0.04629203132197144,20
20064,Nejapa de Madero,7390,3609,3781,-0.02327469553450609,20
20044,Loma Bonita,41535,19779,21756,-0.04759841097869267,20
20036,Guevea de Humboldt,5285,2581,2704,-0.023273415326395458,20
22003,Arroyo Seco,12910,6122,6788,-0.05158791634391944,22
22009,Jalpan de Serra,25550,12192,13358,-0.04563600782778865,22
22010,Landa de Matamoros,19929,9501,10428,-0.04651512870690953,22
22002,Pinal de Amoles,27093,12859,14234,-0.05075111652456354,22
22004,Cadereyta de Montes,64183,30585,33598,-0.04694389480080395,22
22015,San Joaquín,8865,4109,4756,-0.07298364354201918,22
22013,Peñamiller,18441,9013,9428,-0.022504202592050323,22
22018,Tolimán,26372,12757,13615,-0.03253450629455483,22
22005,Colón,58171,28975,29196,-0.0037991439033195234,22
22007,Ezequiel Montes,38123,18213,19910,-0.04451381056055399,22
22011,El Marqués,116458,57547,58911,-0.0117123769942812,22
22014,Querétaro,801940,389403,412537,-0.028847544704092575,22
22017,Tequisquiapan,63413,30752,32661,-0.030104237301499692,22
22016,San Juan del Río,241699,117628,124071,-0.02665712311594173,22
22008,Huimilpan,35554,16930,18624,-0.0476458345052596,22
22012,Pedro Escobedo,63966,31387,32579,-0.01863489979051371,22
22006,Corregidora,143073,69373,73700,-0.03024330237011875,22
22001,Amealco de Bonfil,62197,29842,32355,-0.04040387800054665,22
24058,El Naranjo,20495,10326,10169,0.007660404976823616,24
24057,Matlapa,30299,15053,15246,-0.006369847189676227,24
24056,Villa de Arista,15528,7713,7815,-0.006568778979907265,24
24055,Zaragoza,24596,12105,12491,-0.01569360871686453,24
24054,Xilitla,51498,25484,26014,-0.010291661812109209,24
24053,Axtla de Terrazas,33245,16471,16774,-0.00911415250413596,24
24052,Villa Juárez,10174,4988,5186,-0.01946137212502457,24
24051,Villa Hidalgo,14876,7361,7515,-0.010352245227211615,24
24050,Villa de Reyes,46898,23204,23694,-0.010448206746556356,24
24049,Villa de Ramos,37928,18590,19338,-0.019721577726218097,24
24048,Villa de la Paz,5350,2694,2656,0.007102803738317757,24
24047,Villa de Guadalupe,9779,4920,4859,0.006237856631557419,24
24046,Villa de Arriaga,16316,8117,8199,-0.00502574160333415,24
24045,Venado,14492,7149,7343,-0.013386696108197626,24
24044,Vanegas,7902,3974,3928,0.005821311060491015,24
24043,Tierra Nueva,9024,4268,4756,-0.054078014184397165,24
24042,Tanquián de Escobedo,14382,7077,7305,-0.015853149770546516,24
24041,Tanlajás,19312,9725,9587,0.0071458160729080365,24
24040,Tamuín,37956,18672,19284,-0.01612393297502371,24
24039,Tampamolón Corona,14274,7081,7193,-0.007846434075942273,24
24038,Tampacán,15838,7975,7863,0.0070715999494885716,24
24037,Tamazunchale,96820,47951,48869,-0.009481512084280108,24
24036,Tamasopo,28848,14563,14285,0.009636716583471991,24
24035,Soledad de Graciano Sánchez,267839,129814,138025,-0.03065647646533925,24
24034,San Vicente Tancuayalab,14958,7451,7507,-0.0037438160181842493,24
24033,Santo Domingo,12043,6022,6021,8.30357884248111e-05,24
24032,Santa María del Río,40326,19242,21084,-0.04567772652879036,24
24031,Santa Catarina,11835,5805,6030,-0.019011406844106463,24
24030,San Nicolás Tolentino,5466,2587,2879,-0.05342114892060007,24
24029,San Martín Chalchicuautla,21347,10686,10661,0.0011711247482081792,24
24028,San Luis Potosí,772604,372083,400521,-0.03680798960398859,24
24027,San Ciro de Acosta,10171,4875,5296,-0.041392193491298794,24
24026,San Antonio,9390,4800,4590,0.022364217252396165,24
24025,Salinas,30190,14548,15642,-0.0362371646240477,24
24024,Rioverde,91924,44574,47350,-0.030198859927766417,24
24023,Rayón,15707,7739,7968,-0.014579486852995479,24
24022,Moctezuma,19327,9298,10029,-0.037822735033890414,24
24021,Mexquitic de Carmona,53442,25449,27993,-0.04760300886942854,24
24020,Matehuala,91522,44343,47179,-0.0309870850724416,24
24019,Lagunillas,5774,2839,2935,-0.01662625562868029,24
24018,Huehuetlán,15311,7554,7757,-0.013258441643263013,24
24017,Guadalcázar,25985,13158,12827,0.012738118145083702,24
24016,Ebano,41529,20347,21182,-0.02010643165017217,24
24015,Charcas,21138,10328,10810,-0.022802535717664867,24
24014,Coxcatlán,17015,8544,8471,0.0042903320599471054,24
24013,Ciudad Valles,167713,81226,86487,-0.031369065009868045,24
24012,Tancanhuitz,21039,10406,10633,-0.01078948619230952,24
24011,Ciudad Fernández,43528,21258,22270,-0.02324940268333027,24
24010,Ciudad del Maíz,31323,15523,15800,-0.008843341953197331,24
24009,Cerro de San Pedro,4021,2031,1990,0.010196468540164138,24
24008,Cerritos,21394,10373,11021,-0.030288866037206694,24
24007,Cedral,18485,9048,9437,-0.021044089802542604,24
24006,Catorce,9716,4932,4784,0.015232606010703994,24
24005,Cárdenas,18937,9103,9834,-0.038601679252257486,24
24004,Armadillo de los Infante,4436,2182,2254,-0.016230838593327322,24
24003,Aquismón,47423,23894,23529,0.007696687261455412,24
24002,Alaquines,8186,4068,4118,-0.00610798924993892,24
24001,Ahualulco,18644,8775,9869,-0.058678395194164346,24
11009,Comonfort,77794,36430,41364,-0.06342391444070236,11
11007,Celaya,468469,225024,243445,-0.03932170538498812,11
11025,Purísima del Rincón,68795,33782,35013,-0.017893742277781816,11
11030,San Felipe,106952,51340,55612,-0.03994315206821752,11
11045,Xichú,11560,5534,6026,-0.04256055363321799,11
11013,Doctor Mora,23324,11129,12195,-0.04570399588406791,11
11034,Santa Catarina,5120,2401,2719,-0.062109375,11
11040,Tierra Blanca,18175,8765,9410,-0.03548830811554333,11
11041,Uriangato,59305,28331,30974,-0.04456622544473485,11
11043,Victoria,19820,9365,10455,-0.0549949545913219,11
11006,Atarjea,5610,2748,2862,-0.020320855614973262,11
11028,Salvatierra,97054,45885,51169,-0.054443917818946155,11
11032,San José Iturbide,72411,34637,37774,-0.043322147187582,11
11024,Pueblo Nuevo,11169,5201,5968,-0.0686722177455457,11
11036,Santiago Maravatío,6670,3111,3559,-0.06716641679160419,11
11004,Apaseo el Alto,64433,31177,33256,-0.03226607483742803,11
11005,Apaseo el Grande,85319,41038,44281,-0.038010290791031305,11
11046,Yuriria,70782,33438,37344,-0.055183521234212086,11
11019,Jerécuaro,50832,23555,27277,-0.07322159269751338,11
11039,Tarimoro,35571,16975,18596,-0.04557083017064462,11
11010,Coroneo,11691,5462,6229,-0.0656060217261141,11
11038,Tarandacuao,11641,5511,6130,-0.05317412593419809,11
11011,Cortazar,88397,42650,45747,-0.035035125626435286,11
11002,Acámbaro,109030,51803,57227,-0.04974777584151151,11
11003,San Miguel de Allende,160383,75878,84505,-0.05378999021093258,11
11031,San Francisco del Rincón,113570,55026,58544,-0.030976490270317864,11
11008,Manuel Doblado,37145,17546,19599,-0.0552698882756764,11
11012,Cuerámaro,27308,13071,14237,-0.04269811044382599,11
11042,Valle de Santiago,141058,66846,74212,-0.052219654326589066,11
11033,San Luis de la Paz,115656,54726,60930,-0.05364183440547832,11
11023,Pénjamo,149936,70551,79385,-0.05891847188133604,11
11037,Silao,173024,83948,89076,-0.02963750693545404,11
11001,Abasolo,84332,40281,44051,-0.04470426409903714,11
11016,Huanímaro,20117,9421,10696,-0.06337923149574987,11
11029,San Diego de la Unión,37103,17286,19817,-0.06821550817993154,11
11044,Villagrán,55782,26905,28877,-0.03535190563264135,11
11035,Santa Cruz de Juventino Rosas,79214,37921,41293,-0.042568232888125834,11
11027,Salamanca,260732,126354,134378,-0.03077489529478545,11
11017,Irapuato,529440,254784,274656,-0.037533998186763375,11
11026,Romita,56655,27274,29381,-0.037190009707881035,11
11015,Guanajuato,171709,82830,88879,-0.03522820585991416,11
11020,León,1436480,701781,734699,-0.022915738471820005,11
11018,Jaral del Progreso,36584,17661,18923,-0.03449595451563525,11
11022,Ocampo,22683,10870,11813,-0.04157298417316933,11
11021,Moroleón,49364,23282,26082,-0.05672149744753262,11
11014,Dolores Hidalgo Cuna de la Independencia Nacional,148173,69891,78282,-0.056629750359377215,11
01005,Jesús María,99590,49090,50500,-0.014158047996786827,01
01011,San Francisco de los Romo,35769,17578,18191,-0.017137744974698763,01
01001,Aguascalientes,797010,386429,410581,-0.030303258428376056,01
01008,San José de Gracia,8443,4043,4400,-0.0422835485017174,01
01007,Rincón de Romos,49156,24067,25089,-0.020790951257221905,01
01009,Tepezalá,19668,9600,10068,-0.023794996949359364,01
01004,Cosío,15042,7326,7716,-0.025927403270841642,01
01002,Asientos,45492,22512,22980,-0.010287523080981272,01
01003,Calvillo,54136,26250,27886,-0.03022018619772425,01
01010,El Llano,18828,9573,9255,0.016889738687061822,01
01006,Pabellón de Arteaga,41862,20170,21692,-0.036357555778510346,01
30001,Acajete,8223,4203,4020,0.02225465158701204,30
30002,Acatlán,3085,1501,1584,-0.026904376012965966,30
30003,Acayucan,83817,40242,43575,-0.0397652027631626,30
30004,Actopan,40994,20142,20852,-0.01731960774747524,30
30005,Acula,5129,2556,2573,-0.003314486254630532,30
30006,Acultzingo,20973,10254,10719,-0.022171363181233014,30
30007,Camarón de Tejeda,6224,3103,3121,-0.002892030848329049,30
30008,Alpatláhuac,9691,4809,4882,-0.007532762356825921,30
30009,Alto Lucero de Gutiérrez Barrios,28017,14066,13951,0.004104650747760288,30
30010,Altotonga,60396,29014,31382,-0.03920789456255381,30
30011,Alvarado,51955,25615,26340,-0.01395438360119334,30
30012,Amatitlán,7487,3650,3837,-0.024976626151996795,30
30013,Naranjos Amatlán,27548,13076,14472,-0.050675185131407,30
30014,Amatlán de los Reyes,42268,20591,21677,-0.025693195798239803,30
30015,Angel R. Cabada,33528,16270,17258,-0.029467907420663325,30
30016,La Antigua,25500,12286,13214,-0.0363921568627451,30
30017,Apazapan,4027,1996,2031,-0.008691333498882544,30
30018,Aquila,1797,866,931,-0.036171396772398445,30
30019,Astacinga,5995,2781,3214,-0.07222685571309424,30
30020,Atlahuilco,9824,4711,5113,-0.04092019543973941,30
30021,Atoyac,22986,11078,11908,-0.03610893587401027,30
30022,Atzacan,20063,9865,10198,-0.016597717190848828,30
30023,Atzalan,48397,24140,24257,-0.002417505217265533,30
30024,Tlaltetela,14613,7315,7298,0.00116334770409909,30
30026,Banderilla,21546,10158,11388,-0.05708716235032024,30
30027,Benito Juárez,16692,8142,8550,-0.024442846872753415,30
30028,Boca del Río,138058,64656,73402,-0.06335018615364557,30
30029,Calcahualco,12929,6433,6496,-0.004872766648619383,30
30030,Camerino Z. Mendoza,41778,19778,22000,-0.05318588730911006,30
30031,Carrillo Puerto,16313,7940,8373,-0.026543247716545086,30
30032,Catemaco,48593,23457,25136,-0.034552301771860146,30
30033,Cazones de Herrera,23483,11378,12105,-0.030958565770983264,30
30034,Cerro Azul,25801,12260,13541,-0.04964923840161234,30
30035,Citlaltépetl,11081,5418,5663,-0.022109917877447885,30
30036,Coacoatzintla,9416,4578,4838,-0.027612574341546302,30
30037,Coahuitlán,7810,3861,3949,-0.011267605633802818,30
30038,Coatepec,86696,41788,44908,-0.0359878195072437,30
30039,Coatzacoalcos,305260,147962,157298,-0.03058376465963441,30
30040,Coatzintla,48351,23449,24902,-0.030051084775909495,30
30041,Coetzala,2144,1053,1091,-0.017723880597014924,30
30042,Colipa,5728,2804,2924,-0.02094972067039106,30
30043,Comapa,18713,9527,9186,0.01822262598193769,30
30044,Córdoba,196541,91805,104736,-0.0657928879979241,30
30045,Cosamaloapan de Carpio,57366,27634,29732,-0.03657218561517275,30
30046,Cosautlán de Carvajal,15668,7756,7912,-0.009956599438345672,30
30047,Coscomatepec,52510,25561,26949,-0.026433060369453438,30
30048,Cosoleacaque,117725,56945,60780,-0.03257591845402421,30
30049,Cotaxtla,19710,9770,9940,-0.008625063419583967,30
30050,Coxquihui,15492,7571,7921,-0.022592305706170927,30
30051,Coyutla,21822,10516,11306,-0.03620199798368619,30
30052,Cuichapa,11645,5527,6118,-0.05075139544869042,30
30053,Cuitláhuac,26265,12469,13796,-0.0505235103750238,30
30054,Chacaltianguis,11683,5686,5997,-0.02661987503209792,30
30057,Chiconquiaco,13190,6529,6661,-0.010007581501137225,30
30058,Chicontepec,54982,26729,28253,-0.027718162307664326,30
30059,Chinameca,15214,7404,7810,-0.026685947153937163,30
30060,Chinampa de Gorostiza,15286,7477,7809,-0.02171922020149156,30
30061,Las Choapas,77426,38042,39384,-0.017332678945057217,30
30062,Chocamán,18601,9173,9428,-0.013708940379549487,30
30063,Chontla,14688,7349,7339,0.0006808278867102397,30
30064,Chumatlán,3889,1899,1990,-0.023399331447672922,30
30065,Emiliano Zapata,61718,30300,31418,-0.0181146505071454,30
30066,Espinal,25548,12407,13141,-0.028730233286362924,30
30067,Filomeno Mata,16418,8180,8238,-0.0035327080034108903,30
30068,Fortín,59761,28261,31500,-0.054199226920566924,30
30069,Gutiérrez Zamora,24353,11436,12917,-0.06081386276844742,30
30070,Hidalgotitlán,18277,9220,9057,0.008918312633364338,30
30071,Huatusco,54561,26216,28345,-0.0390205458111105,30
30072,Huayacocotla,20765,10014,10751,-0.03549241512159884,30
30073,Hueyapan de Ocampo,41649,20276,21373,-0.026339167807150232,30
30074,Huiloapan de Cuauhtémoc,6750,3253,3497,-0.03614814814814815,30
30075,Ignacio de la Llave,17121,8293,8828,-0.031248174756147423,30
30076,Ilamatlán,13575,6423,7152,-0.053701657458563534,30
30077,Isla,42205,20520,21685,-0.027603364530268924,30
30078,Ixcatepec,12713,6340,6373,-0.00259576811138205,30
30079,Ixhuacán de los Reyes,10724,5400,5324,0.007086907870197687,30
30080,Ixhuatlán del Café,21407,10541,10866,-0.015181949829495025,30
30081,Ixhuatlancillo,21150,10121,11029,-0.04293144208037825,30
30082,Ixhuatlán del Sureste,14903,7361,7542,-0.01214520566328927,30
30083,Ixhuatlán de Madero,49820,24351,25469,-0.02244078683259735,30
30084,Ixmatlahuacan,5727,2856,2871,-0.0026191723415400735,30
30085,Ixtaczoquitlán,65385,31521,33864,-0.03583390685937141,30
30086,Jalacingo,40747,19969,20778,-0.019854222396740864,30
30087,Xalapa,457928,213571,244357,-0.06722890934819448,30
30088,Jalcomulco,4940,2480,2460,0.004048582995951417,30
30089,Jáltipan,39673,18929,20744,-0.04574899805913341,30
30090,Jamapa,10376,5085,5291,-0.01985350809560524,30
30091,Jesús Carranza,27080,13394,13686,-0.010782865583456425,30
30092,Xico,35188,17276,17912,-0.018074343526202113,30
30093,Jilotepec,15313,7401,7912,-0.033370338927708486,30
30094,Juan Rodríguez Clara,37193,18326,18867,-0.014545747855779313,30
30095,Juchique de Ferrer,16387,8067,8320,-0.015439067553548545,30
30096,Landero y Coss,1546,746,800,-0.03492884864165589,30
30097,Lerdo de Tejada,20141,9468,10673,-0.059828211111662775,30
30098,Magdalena,2920,1443,1477,-0.011643835616438357,30
30099,Maltrata,16898,8098,8800,-0.0415433779145461,30
30100,Manlio Fabio Altamirano,22585,11171,11414,-0.010759353553243303,30
30101,Mariano Escobedo,33941,16253,17688,-0.04227924928552488,30
30102,Martínez de la Torre,101358,48561,52797,-0.04179245841472799,30
30103,Mecatlán,11808,5787,6021,-0.019817073170731708,30
30105,Medellín,59126,28431,30695,-0.03829110712715218,30
30106,Miahuatlán,4429,2154,2275,-0.027319936780311582,30
30107,Las Minas,2897,1468,1429,0.013462202278218847,30
30108,Minatitlán,157840,76222,81618,-0.03418651799290421,30
30109,Misantla,62919,30771,32148,-0.021885281075668717,30
30110,Mixtla de Altamirano,10387,5221,5166,0.005295080388947723,30
30111,Moloacán,16120,7851,8269,-0.025930521091811414,30
30112,Naolinco,20255,9861,10394,-0.026314490249321157,30
30113,Naranjal,4507,2163,2344,-0.04015975149767029,30
30114,Nautla,9974,4873,5101,-0.02285943452977742,30
30115,Nogales,34688,16604,18084,-0.0426660516605166,30
30116,Oluta,14784,7097,7687,-0.039908008658008656,30
30117,Omealca,22561,10850,11711,-0.038163201985727584,30
30118,Orizaba,120995,55845,65150,-0.07690400429769825,30
30119,Otatitlán,5250,2511,2739,-0.04342857142857143,30
30120,Oteapan,14965,7289,7676,-0.025860340795188775,30
30121,Ozuluama de Mascareñas,23276,11937,11339,0.025691699604743084,30
30122,Pajapan,15909,7923,7986,-0.003960022628700735,30
30123,Pánuco,97290,48357,48933,-0.0059204440333024974,30
30124,Papantla,158599,77291,81308,-0.025328028549990857,30
30125,Paso del Macho,29165,14390,14775,-0.01320075432881879,30
30126,Paso de Ovejas,32576,16252,16324,-0.0022102161100196463,30
30127,La Perla,23648,11498,12150,-0.02757104194857916,30
30128,Perote,68982,34642,34340,0.004377953669073092,30
30129,Platón Sánchez,17888,8780,9108,-0.018336314847942754,30
30130,Playa Vicente,40984,19660,21324,-0.040601210228381805,30
30131,Poza Rica de Hidalgo,193311,91390,101921,-0.05447698268593096,30
30132,Las Vigas de Ramírez,17958,8889,9069,-0.010023387905111928,30
30133,Pueblo Viejo,55358,27668,27690,-0.0003974132013439792,30
30134,Puente Nacional,21603,10628,10975,-0.016062583900384206,30
30135,Rafael Delgado,20245,9978,10267,-0.014275129661644851,30
30136,Rafael Lucio,7023,3405,3618,-0.030328919265271252,30
30137,Los Reyes,5484,2696,2788,-0.016776075857038657,30
30138,Río Blanco,40634,19042,21592,-0.06275532805040114,30
30139,Saltabarranca,5908,2864,3044,-0.03046716316858497,30
30140,San Andrés Tenejapan,2715,1311,1404,-0.03425414364640884,30
30141,San Andrés Tuxtla,157364,75604,81760,-0.039119493658015814,30
30142,San Juan Evangelista,33435,16442,16993,-0.016479736802751607,30
30143,Santiago Tuxtla,56427,27099,29328,-0.039502365888670316,30
30144,Sayula de Alemán,31974,15604,16370,-0.0239569650340902,30
30145,Soconusco,14395,6994,7401,-0.028273706147968043,30
30146,Sochiapa,3502,1749,1753,-0.001142204454597373,30
30147,Soledad Atzompa,21380,10496,10884,-0.01814780168381665,30
30148,Soledad de Doblado,27008,13339,13669,-0.012218601895734597,30
30149,Soteapan,32596,15964,16632,-0.020493312062829797,30
30152,Tampico Alto,12242,6329,5913,0.033981375592223494,30
30153,Tancoco,5873,2867,3006,-0.023667631534139283,30
30154,Tantima,12814,6483,6331,0.011862025909161853,30
30155,Tantoyuca,101743,50432,51311,-0.008639414996609104,30
30156,Tatatila,5584,2903,2681,0.03975644699140401,30
30157,Castillo de Teayo,18663,9334,9329,0.0002679097679901409,30
30158,Tecolutla,25126,12351,12775,-0.01687495025073629,30
30159,Tehuipango,23479,11298,12181,-0.03760807530133311,30
30160,Álamo Temapache,104499,51618,52881,-0.012086240059713491,30
30161,Tempoal,34956,17311,17645,-0.009554868978143952,30
30162,Tenampa,6247,3053,3194,-0.022570834000320155,30
30163,Tenochtitlán,5222,2486,2736,-0.04787437763309077,30
30164,Teocelo,16327,7982,8345,-0.022233110798064556,30
30165,Tepatlaxco,8249,4207,4042,0.02000242453630743,30
30166,Tepetlán,9004,4545,4459,0.009551310528653932,30
30167,Tepetzintla,13949,6918,7031,-0.008100939135421894,30
30168,Tequila,14648,7202,7446,-0.016657564172583288,30
30169,José Azueta,23999,11727,12272,-0.022709279553314723,30
30170,Texcatepec,10627,5149,5478,-0.03095887832878517,30
30171,Texhuacán,5292,2492,2800,-0.0582010582010582,30
30172,Texistepec,20199,10063,10136,-0.003614040299024704,30
30173,Tezonapa,52584,25931,26653,-0.013730412292712612,30
30174,Tierra Blanca,94087,45203,48884,-0.03912336454558015,30
30175,Tihuatlán,89774,43978,45796,-0.020250852139817765,30
30176,Tlacojalpan,4632,2285,2347,-0.013385146804835924,30
30177,Tlacolulan,10299,5189,5110,0.007670647635692786,30
30178,Tlacotalpan,13284,6415,6869,-0.03417645287563987,30
30179,Tlacotepec de Mejía,3965,1944,2021,-0.019419924337957126,30
30180,Tlachichilco,11276,5563,5713,-0.013302589570769777,30
30181,Tlalixcoyan,37037,18181,18856,-0.018225018225018225,30
30182,Tlalnelhuayocan,16311,7940,8371,-0.026423885721292378,30
30183,Tlapacoyan,58084,28079,30005,-0.03315887335582949,30
30184,Tlaquilpa,7151,3333,3818,-0.06782268214235772,30
30185,Tlilapan,4879,2358,2521,-0.033408485345357654,30
30186,Tomatlán,6763,3330,3433,-0.01522992754694662,30
30187,Tonayán,5696,2752,2944,-0.033707865168539325,30
30188,Totutla,16403,8176,8227,-0.003109187343778577,30
30189,Tuxpan,143362,69764,73598,-0.026743488511600005,30
30190,Tuxtilla,2177,1078,1099,-0.00964630225080386,30
30191,Ursulo Galván,29005,14077,14928,-0.029339769005343908,30
30192,Vega de Alatorre,19541,9477,10064,-0.030039404329358785,30
30194,Villa Aldama,10851,5333,5518,-0.017049119896783708,30
30195,Xoxocotla,5163,2611,2552,0.011427464652333914,30
30196,Yanga,17462,8204,9258,-0.06035963807124041,30
30197,Yecuatla,11357,5580,5777,-0.01734613014000176,30
30198,Zacualpan,6784,3262,3522,-0.038325471698113206,30
30199,Zaragoza,10720,5190,5530,-0.03171641791044776,30
30200,Zentla,12379,6205,6174,0.002504241053396882,30
30201,Zongolica,41923,20699,21224,-0.012522958757722491,30
30202,Zontecomatlán de López y Fuentes,13866,6868,6998,-0.009375450742824174,30
30203,Zozocolco de Hidalgo,13434,6599,6835,-0.017567366383802293,30
30204,Agua Dulce,46010,22329,23681,-0.02938491632253858,30
30205,El Higo,19128,9512,9616,-0.005437055625261397,30
30206,Nanchital de Lázaro Cárdenas del Río,27094,12978,14116,-0.04200191924411309,30
30207,Tres Valles,45095,21938,23157,-0.027031821709723916,30
30208,Carlos A. Carrillo,22907,10921,11986,-0.046492338586458286,30
30209,Tatahuicapan de Juárez,14297,7061,7236,-0.01224033013919004,30
30210,Uxpanapa,27346,13681,13665,0.0005850947122065384,30
30211,San Rafael,29277,14219,15058,-0.028657307784267515,30
30212,Santiago Sochiapan,12409,5986,6423,-0.03521637521154001,30
29020,Sanctórum de Lázaro Cárdenas,8474,4167,4307,-0.016521123436393673,29
29060,Santa Isabel Xiloxoxtla,4436,2138,2298,-0.03606853020739405,29
29059,Santa Cruz Quilehtla,6296,3109,3187,-0.01238881829733164,29
29058,Santa Catarina Ayometla,7992,3840,4152,-0.03903903903903904,29
29057,Santa Apolonia Teacalco,4349,2034,2315,-0.06461255461025524,29
29056,Santa Ana Nopalucan,6857,3348,3509,-0.023479655826163046,29
29055,San Lucas Tecopilco,2833,1342,1491,-0.05259442287327921,29
29053,San Juan Huactzinco,6821,3221,3600,-0.05556370033719396,29
29052,San José Teacalco,5660,2744,2916,-0.0303886925795053,29
29050,San Francisco Tetlanohcan,9880,4780,5100,-0.032388663967611336,29
29049,San Damián Texóloc,5064,2508,2556,-0.009478672985781991,29
29048,La Magdalena Tlaltelulco,16834,8089,8745,-0.03896875371272425,29
29047,Lázaro Cárdenas,2769,1349,1420,-0.02564102564102564,29
29046,Emiliano Zapata,4146,1999,2147,-0.03569705740472745,29
29045,Benito Juárez,5687,2757,2930,-0.03042025672586601,29
29044,Zacatelco,38654,18499,20155,-0.04284162053086356,29
29043,Yauhquemehcan,33081,15941,17140,-0.036244369879991536,29
29042,Xicohtzinco,12255,5856,6399,-0.04430844553243574,29
29041,Papalotla de Xicohténcatl,26997,12969,14028,-0.039226580731192354,29
29040,Xaltocan,9777,4701,5076,-0.03835532371893219,29
29039,Xaloztoc,21769,10847,10922,-0.0034452662042353806,29
29038,Tzompantepec,14611,7083,7528,-0.030456505372664432,29
29037,Ziltlaltépec de Trinidad Sánchez Santos,8224,3935,4289,-0.04304474708171206,29
29036,Totolac,20625,9854,10771,-0.04446060606060606,29
29035,Tocatlán,5589,2756,2833,-0.01377706208624083,29
29034,Tlaxco,39939,19507,20432,-0.023160319487218008,29
29033,Tlaxcala,89795,42529,47266,-0.05275349406982571,29
29032,Tetlatlahuca,12410,5980,6430,-0.0362610797743755,29
29031,Tetla de la Solidaridad,28760,14026,14734,-0.024617524339360222,29
29030,Terrenate,13775,6838,6937,-0.007186932849364791,29
29029,Tepeyanco,11048,5233,5815,-0.05267921795800145,29
29028,Teolocholco,21671,10426,11245,-0.03779244151169766,29
29027,Tenancingo,11763,5732,6031,-0.025418685709427867,29
29026,Santa Cruz Tlaxcala,17968,8832,9136,-0.016918967052537846,29
29025,San Pablo del Monte,69615,34281,35334,-0.015126050420168067,29
29024,Panotla,25128,12073,13055,-0.039079910856415156,29
29023,Natívitas,23621,11330,12291,-0.040684136996740186,29
29022,Acuamanala de Miguel Hidalgo,5711,2846,2865,-0.0033269129749606023,29
29021,Nanacamilpa de Mariano Arista,16640,8127,8513,-0.023197115384615385,29
29019,Tepetitla de Lardizábal,18725,8990,9735,-0.03978638184245661,29
29018,Contla de Juan Cuamatzi,35084,17162,17922,-0.02166229620339756,29
29017,Mazatecochco de José María Morelos,9740,4764,4976,-0.021765913757700206,29
29016,Ixtenco,6791,3245,3546,-0.044323369165071416,29
29015,Ixtacuixtla de Mariano Matamoros,35162,16917,18245,-0.03776804504863204,29
29014,Hueyotlipan,13879,6839,7040,-0.014482311405720873,29
29013,Huamantla,84979,41296,43683,-0.02808929264877205,29
29012,Españita,8399,4151,4248,-0.011548993927848554,29
29011,Muñoz de Domingo Arenas,4285,2156,2129,0.006301050175029172,29
29010,Chiautempan,66149,31651,34498,-0.04303919938321063,29
29009,Cuaxomulco,5066,2504,2562,-0.011448874851954205,29
29008,Cuapiaxtla,13671,6801,6870,-0.005047180162387536,29
29007,El Carmen Tequexquitla,15368,7527,7841,-0.02043206663196252,29
29006,Calpulalpan,44807,21730,23077,-0.03006226705648671,29
29005,Apizaco,76492,36269,40223,-0.05169168017570465,29
29004,Atltzayanca,15935,7904,8031,-0.007969877627863194,29
29003,Atlangatepec,6018,2914,3104,-0.031571950814223995,29
29002,Apetatitlán de Antonio Carvajal,13361,6424,6937,-0.0383953296908914,29
21027,Caltepec,4177,1953,2224,-0.0648790998324156,21
21047,Chiautla,19037,9191,9846,-0.03440668172506172,21
21072,Huehuetla,15689,7706,7983,-0.017655682325195998,21
21073,Huehuetlán el Chico,8679,4179,4500,-0.03698582786035257,21
21088,Jonotla,4598,2237,2361,-0.026968247063940843,21
21155,Tecomatlán,5420,2578,2842,-0.04870848708487085,21
21216,Zoquiapan,2639,1251,1388,-0.05191360363774157,21
21001,Acajete,60353,29225,31128,-0.031531158351697515,21
21002,Acateno,8916,4484,4432,0.005832211754149843,21
21004,Acatzingo,52078,25298,26780,-0.028457314028956564,21
21005,Acteopan,2881,1340,1541,-0.06976744186046512,21
21006,Ahuacatlán,14754,7087,7667,-0.039311373186932355,21
21007,Ahuatlán,3403,1662,1741,-0.023214810461357625,21
21008,Ahuazotepec,10457,5127,5330,-0.01941283350865449,21
21009,Ahuehuetitla,2008,935,1073,-0.06872509960159362,21
21010,Ajalpan,60621,29304,31317,-0.03320631464344039,21
21011,Albino Zertuche,1770,811,959,-0.08361581920903954,21
21012,Aljojuca,6288,2934,3354,-0.06679389312977099,21
21013,Altepexi,18920,9109,9811,-0.03710359408033827,21
21014,Amixtlán,5004,2370,2634,-0.05275779376498801,21
21015,Amozoc,100964,49098,51866,-0.02741571253119924,21
21016,Aquixtla,7848,3900,3948,-0.0061162079510703364,21
21017,Atempan,25386,12278,13108,-0.03269518632317025,21
21018,Atexcal,3734,1790,1944,-0.04124263524370648,21
21019,Atlixco,127062,59360,67702,-0.065652988304922,21
21020,Atoyatempan,6426,3099,3327,-0.035480859010270774,21
21021,Atzala,1228,585,643,-0.04723127035830619,21
21022,Atzitzihuacán,11684,5329,6355,-0.08781239301609038,21
21023,Atzitzintla,8408,4118,4290,-0.020456707897240724,21
21024,Axutla,947,439,508,-0.07286166842661035,21
21025,Ayotoxco de Guerrero,8153,3993,4160,-0.020483257696553417,21
21026,Calpan,13730,6464,7266,-0.0584122359796067,21
21028,Camocuautla,2476,1214,1262,-0.01938610662358643,21
21029,Caxhuacan,3791,1810,1981,-0.04510683197045635,21
21030,Coatepec,758,359,399,-0.052770448548812667,21
21031,Coatzingo,2964,1403,1561,-0.053306342780026994,21
21032,Cohetzala,1283,646,637,0.007014809041309431,21
21033,Cohuecan,4763,2258,2505,-0.05185807264329204,21
21034,Coronango,34596,16758,17838,-0.031217481789802288,21
21035,Coxcatlán,19639,9368,10271,-0.04597993787871073,21
21036,Coyomeapan,14205,6801,7404,-0.042449841605068636,21
21037,Coyotepec,2339,1081,1258,-0.07567336468576315,21
21038,Cuapiaxtla de Madero,8709,4286,4423,-0.015730853140429442,21
21039,Cuautempan,9212,4408,4804,-0.04298740772904907,21
21040,Cuautinchán,9538,4697,4841,-0.015097504717970224,21
21041,Cuautlancingo,79153,38477,40676,-0.027781638093312952,21
21042,Cuayuca de Andrade,3062,1457,1605,-0.048334421946440234,21
21043,Cuetzalan del Progreso,47433,23240,24193,-0.020091497480656927,21
21044,Cuyoaco,15367,7412,7955,-0.03533545910067027,21
21045,Chalchicomula de Sesma,43882,21092,22790,-0.03869468119046534,21
21046,Chapulco,6992,3343,3649,-0.043764302059496565,21
21048,Chiautzingo,18762,8846,9916,-0.05703016735955655,21
21049,Chiconcuautla,15767,7696,8071,-0.023783852349844613,21
21050,Chichiquila,24148,11918,12230,-0.012920324664568494,21
21051,Chietla,33935,16288,17647,-0.040047148961249446,21
21052,Chigmecatitlán,1227,581,646,-0.05297473512632437,21
21053,Chignahuapan,57909,28228,29681,-0.025091091194805643,21
21054,Chignautla,30254,14669,15585,-0.03027698816685397,21
21055,Chila,4699,2169,2530,-0.07682485635241541,21
21056,Chila de la Sal,1237,571,666,-0.07679870654810024,21
21057,Honey,7463,3552,3911,-0.04810397963285542,21
21058,Chilchotla,19257,9682,9575,0.005556421041699122,21
21059,Chinantla,2468,1151,1317,-0.06726094003241491,21
21060,Domingo Arenas,6946,3296,3650,-0.05096458393319896,21
21061,Eloxochitlán,12575,6181,6394,-0.016938369781312128,21
21062,Epatlán,4594,2216,2378,-0.035263387026556375,21
21063,Esperanza,13785,6593,7192,-0.043453028654334425,21
21064,Francisco Z. Mena,16270,8154,8116,0.002335586969883221,21
21065,General Felipe Ángeles,19040,9125,9915,-0.04149159663865546,21
21066,Guadalupe,6276,2919,3357,-0.06978967495219886,21
21067,Guadalupe Victoria,16551,8006,8545,-0.032566008096187544,21
21068,Hermenegildo Galeana,7718,3849,3869,-0.002591344908007256,21
21069,Huaquechula,25373,11681,13692,-0.07925747842194458,21
21070,Huatlatlauca,6643,3051,3592,-0.08143910883636911,21
21071,Huauchinango,97753,46336,51417,-0.05197794441091322,21
21074,Huejotzingo,63457,30723,32734,-0.031690751217359786,21
21075,Hueyapan,11868,5787,6081,-0.024772497472194135,21
21076,Hueytamalco,26689,13208,13481,-0.010228933268387726,21
21077,Hueytlalpan,5734,2827,2907,-0.013951866062085804,21
21078,Huitzilan de Serdán,13982,7049,6933,0.008296381061364612,21
21079,Huitziltepec,5306,2534,2772,-0.044854881266490766,21
21080,Atlequizayan,2833,1328,1505,-0.06247793858100953,21
21081,Ixcamilpa de Guerrero,3695,1756,1939,-0.04952638700947226,21
21082,Ixcaquixtla,8093,3857,4236,-0.04683059434078834,21
21083,Ixtacamaxtitlán,25326,12524,12802,-0.01097686172313038,21
21084,Ixtepec,6811,3285,3526,-0.035383937747760975,21
21085,Izúcar de Matamoros,72799,34451,38348,-0.05353095509553703,21
21086,Jalpan,12547,6067,6480,-0.032916234956563324,21
21087,Jolalpan,12662,6006,6656,-0.0513347022587269,21
21089,Jopala,12997,6327,6670,-0.026390705547434022,21
21090,Juan C. Bonilla,18540,8881,9659,-0.041963322545846816,21
21091,Juan Galindo,10213,4800,5413,-0.06002154117301479,21
21092,Juan N. Méndez,5223,2562,2661,-0.018954623779437105,21
21093,Lafragua,7767,3806,3961,-0.019956225054718682,21
21094,Libres,31532,15224,16308,-0.03437777495877204,21
21096,Mazapiltepec de Juárez,2633,1303,1330,-0.010254462590201291,21
21097,Mixtla,2216,1032,1184,-0.06859205776173286,21
21098,Molcaxac,6218,2902,3316,-0.06658089417819235,21
21099,Cañada Morelos,18954,9132,9822,-0.03640392529281418,21
21100,Naupan,9707,4610,5097,-0.05016998042649634,21
21101,Nauzontla,3598,1695,1903,-0.057809894385769875,21
21102,Nealtican,12011,5746,6265,-0.04321039047539755,21
21103,Nicolás Bravo,6009,2915,3094,-0.02978865035779664,21
21104,Nopalucan,27292,13259,14033,-0.028359958962333284,21
21105,Ocotepec,4825,2329,2496,-0.03461139896373057,21
21106,Ocoyucan,25720,12128,13592,-0.056920684292379474,21
21107,Olintla,11641,5681,5960,-0.023967013143200756,21
21108,Oriental,16575,8009,8566,-0.03360482654600302,21
21109,Pahuatlán,20618,9905,10713,-0.039189058104568825,21
21110,Palmar de Bravo,42887,20914,21973,-0.02469279735117868,21
21111,Pantepec,18435,8947,9488,-0.029346352047735287,21
21112,Petlalcingo,9382,4356,5026,-0.07141334470262205,21
21113,Piaxtla,4585,2187,2398,-0.046019629225736096,21
21114,Puebla,1539819,734352,805467,-0.04618399954799882,21
21115,Quecholac,47281,23041,24240,-0.02535902370931241,21
21116,Quimixtlán,21275,10572,10703,-0.0061574618096357225,21
21118,Los Reyes de Juárez,25553,12390,13163,-0.03025085117207373,21
21119,San Andrés Cholula,100439,48650,51789,-0.03125280020709087,21
21120,San Antonio Cañada,5110,2393,2717,-0.06340508806262231,21
21121,San Diego la Mesa Tochimiltzingo,1132,549,583,-0.030035335689045935,21
21122,San Felipe Teotlalcingo,9426,4564,4862,-0.03161468279227668,21
21123,San Felipe Tepatlán,4120,2022,2098,-0.018446601941747572,21
21124,San Gabriel Chilac,14454,6818,7636,-0.056593330565933304,21
21125,San Gregorio Atzompa,8170,3864,4306,-0.054100367197062425,21
21126,San Jerónimo Tecuanipan,5826,2762,3064,-0.051836594576038446,21
21127,San Jerónimo Xayacatlán,3777,1757,2020,-0.06963198305533493,21
21128,San José Chiapa,8087,3966,4121,-0.019166563620625694,21
21129,San José Miahuatlán,12699,5941,6758,-0.06433577447043075,21
21130,San Juan Atenco,3416,1582,1834,-0.07377049180327869,21
21131,San Juan Atzompa,872,442,430,0.013761467889908258,21
21132,San Martín Texmelucan,141112,67505,73607,-0.04324224729293044,21
21134,San Matías Tlalancaleca,19310,9406,9904,-0.02578974624546867,21
21135,San Miguel Ixitlán,586,282,304,-0.03754266211604096,21
21136,San Miguel Xoxtla,11598,5624,5974,-0.030177616830488016,21
21137,San Nicolás Buenos Aires,9185,4471,4714,-0.026456178551986936,21
21138,San Nicolás de los Ranchos,10777,5190,5587,-0.036837709937830566,21
21139,San Pablo Anicano,3554,1690,1864,-0.04895891952729319,21
21140,San Pedro Cholula,120459,57578,62881,-0.04402327762973294,21
21141,San Pedro Yeloixtlahuaca,3395,1628,1767,-0.04094256259204713,21
21142,San Salvador el Seco,27622,13391,14231,-0.030410542321338063,21
21143,San Salvador el Verde,28419,13816,14603,-0.02769274077201872,21
21144,San Salvador Huixcolotla,13541,6663,6878,-0.015877704748541468,21
21145,San Sebastián Tlacotepec,13534,6668,6866,-0.014629821191074331,21
21146,Santa Catarina Tlaltempan,874,439,435,0.004576659038901602,21
21147,Santa Inés Ahuatempan,5944,2861,3083,-0.037348586810228804,21
21148,Santa Isabel Cholula,8040,3853,4187,-0.04154228855721393,21
21149,Santiago Miahuatlán,21993,10595,11398,-0.0365116173327877,21
21150,Huehuetlán el Grande,7060,3418,3642,-0.03172804532577904,21
21151,Santo Tomás Hueyotlipan,8016,3822,4194,-0.04640718562874251,21
21152,Soltepec,11706,5702,6004,-0.02579873569109858,21
21153,Tecali de Herrera,20267,9770,10497,-0.03587112054078058,21
21154,Tecamachalco,71571,34365,37206,-0.03969484847214654,21
21156,Tehuacán,274906,129484,145422,-0.05797618094912443,21
21157,Tehuitzingo,11328,5360,5968,-0.05367231638418079,21
21158,Tenampulco,6772,3327,3445,-0.017424689899586534,21
21159,Teopantlán,4024,1807,2217,-0.10188866799204771,21
21160,Teotlalco,3121,1514,1607,-0.029798141621275233,21
21161,Tepanco de López,19002,8916,10086,-0.06157246605620461,21
21162,Tepango de Rodríguez,4244,2003,2241,-0.056079170593779454,21
21163,Tepatlaxco de Hidalgo,16275,7831,8444,-0.037665130568356374,21
21164,Tepeaca,74708,35672,39036,-0.04502864485731113,21
21165,Tepemaxalco,1141,547,594,-0.04119193689745837,21
21166,Tepeojuma,8056,3655,4401,-0.09260178748758689,21
21167,Tepetzintla,10240,4944,5296,-0.034375,21
21168,Tepexco,6580,3160,3420,-0.03951367781155015,21
21169,Tepexi de Rodríguez,20478,10400,10078,0.015724191815606994,21
21170,Tepeyahualco,16390,8087,8303,-0.01317876754118365,21
21171,Tepeyahualco de Cuauhtémoc,3365,1601,1764,-0.04843982169390788,21
21172,Tetela de Ocampo,25793,12341,13452,-0.04307370216725468,21
21173,Teteles de Avila Castillo,5689,2633,3056,-0.07435401652311478,21
21174,Teziutlán,92246,43462,48784,-0.05769355852828307,21
21175,Tianguismanalco,9807,4626,5181,-0.056592230039767516,21
21176,Tilapa,8401,4016,4385,-0.043923342459231046,21
21177,Tlacotepec de Benito Juárez,48268,22926,25342,-0.05005386591530621,21
21178,Tlacuilotepec,17115,8406,8709,-0.017703768624014023,21
21179,Tlachichuca,28568,13950,14618,-0.023382805936712405,21
21180,Tlahuapan,36518,17975,18543,-0.01555397338298921,21
21181,Tlaltenango,6269,3103,3166,-0.010049449672994098,21
21182,Tlanepantla,4833,2325,2508,-0.03786468032278088,21
21183,Tlaola,19826,9672,10154,-0.02431151013820236,21
21184,Tlapacoya,6406,3128,3278,-0.023415547923821417,21
21185,Tlapanalá,8404,3930,4474,-0.06473108043788672,21
21186,Tlatlauquitepec,51495,24722,26773,-0.03982910962229343,21
21187,Tlaxco,5415,2663,2752,-0.016435826408125576,21
21188,Tochimilco,17028,7916,9112,-0.07023725628376791,21
21189,Tochtepec,19701,9439,10262,-0.04177452921171514,21
21190,Totoltepec de Guerrero,1155,526,629,-0.08917748917748917,21
21191,Tulcingo,9245,4275,4970,-0.07517577068685775,21
21192,Tuzamapan de Galeana,5983,2892,3091,-0.03326090590005014,21
21193,Tzicatlacoyan,6242,3062,3180,-0.018904197372636974,21
21194,Venustiano Carranza,27890,13474,14416,-0.033775546790964506,21
21195,Vicente Guerrero,24217,11592,12625,-0.042655985464756165,21
21196,Xayacatlán de Bravo,1649,752,897,-0.08793208004851426,21
21197,Xicotepec,75601,36390,39211,-0.03731432123913705,21
21198,Xicotlán,1241,583,658,-0.060435132957292505,21
21200,Xochiapulco,3911,1906,2005,-0.02531321912554334,21
21201,Xochiltepec,3187,1437,1750,-0.09821148415437715,21
21202,Xochitlán de Vicente Suárez,12249,5977,6272,-0.02408359866111519,21
21203,Xochitlán Todos Santos,6049,2872,3177,-0.050421557282195405,21
21204,Yaonáhuac,7514,3613,3901,-0.038328453553367045,21
21205,Yehualtepec,22976,11113,11863,-0.03264275766016713,21
21206,Zacapala,4224,1962,2262,-0.07102272727272728,21
21207,Zacapoaxtla,53295,25534,27761,-0.04178628389154705,21
21208,Zacatlán,76296,36133,40163,-0.052820593478032925,21
21209,Zapotitlán,8220,3712,4508,-0.09683698296836983,21
21210,Zapotitlán de Méndez,5608,2779,2829,-0.00891583452211127,21
21211,Zaragoza,15444,7152,8292,-0.07381507381507381,21
21212,Zautla,19438,9186,10252,-0.05484103302808931,21
21213,Zihuateutla,12530,6112,6418,-0.024421388667198722,21
21214,Zinacatepec,15690,7374,8316,-0.060038240917782024,21
21215,Zongozotla,4599,2258,2341,-0.018047401609045444,21
21217,Zoquitlán,20529,9987,10542,-0.027034926201958204,21
21199,Xiutetelco,37910,18326,19584,-0.033183856502242155,21
13035,Metepec,11429,5339,6090,-0.06571003587365473,13
13007,Almoloya,11294,5593,5701,-0.009562599610412609,13
13008,Apan,42563,20359,22204,-0.04334750839931396,13
13001,Acatlán,20077,9669,10408,-0.036808288090850225,13
13002,Acaxochitlán,40583,19390,21193,-0.0444274696301407,13
13003,Actopan,54299,25741,28558,-0.051879408460560966,13
13004,Agua Blanca de Iturbide,8994,4294,4700,-0.04514120524794307,13
13006,Alfajayucan,18879,9208,9671,-0.024524604057418294,13
13011,Atlapexco,19452,9370,10082,-0.036602920008225376,13
13012,Atotonilco el Grande,26940,12776,14164,-0.05152190051967335,13
13014,Calnali,16962,8195,8767,-0.03372243839169909,13
13015,Cardonal,18427,8919,9508,-0.03196396591957454,13
13016,Cuautepec de Hinojosa,54500,25893,28607,-0.04979816513761468,13
13018,Chapulhuacán,22402,11328,11074,0.011338273368449246,13
13022,Epazoyucan,13830,6739,7091,-0.025451916124367317,13
13024,Huasca de Ocampo,17182,8261,8921,-0.03841229193341869,13
13025,Huautla,22621,10930,11691,-0.033641306750364704,13
13026,Huazalingo,12779,6295,6484,-0.014789889662727913,13
13027,Huehuetla,23563,11427,12136,-0.03008954717141281,13
13028,Huejutla de Reyes,122905,60254,62651,-0.019502868068833654,13
13030,Ixmiquilpan,86363,40740,45623,-0.0565404166135961,13
13031,Jacala de Ledezma,12804,6098,6706,-0.047485160887222745,13
13032,Jaltocán,10933,5416,5517,-0.009238086527028263,13
13033,Juárez Hidalgo,3193,1546,1647,-0.031631694331349824,13
13034,Lolotla,9843,4831,5012,-0.018388702631311593,13
13036,San Agustín Metzquititlán,9364,4480,4884,-0.043143955574540795,13
13038,Mineral del Chico,7980,3875,4105,-0.02882205513784461,13
13039,Mineral del Monte,13864,6599,7265,-0.04803808424697057,13
13040,La Misión,10452,5147,5305,-0.015116724071947953,13
13042,Molango de Escamilla,11209,5519,5690,-0.015255598180033901,13
13043,Nicolás Flores,6614,3177,3437,-0.03931055337163592,13
13045,Omitlán de Juárez,8963,4299,4664,-0.04072297221912306,13
13046,San Felipe Orizatlán,39181,19406,19775,-0.009417830070697531,13
13047,Pacula,5049,2354,2695,-0.06753812636165578,13
13049,Pisaflores,18244,9115,9129,-0.0007673755755316816,13
13051,Mineral de la Reforma,127404,60921,66483,-0.04365640011302628,13
13053,San Bartolo Tutotepec,18137,9006,9131,-0.0068919887522743565,13
13055,Santiago de Anaya,16014,7763,8251,-0.030473335831147745,13
13056,Santiago Tulantepec de Lugo Guerrero,33495,15938,17557,-0.04833557247350351,13
13057,Singuilucan,14851,7252,7599,-0.023365429937377953,13
13058,Tasquillo,16865,7744,9121,-0.08164838422769048,13
13060,Tenango de Doria,17206,8307,8899,-0.03440660234801814,13
13062,Tepehuacán de Guerrero,29125,14788,14337,0.015484978540772533,13
13068,Tianguistengo,14037,6853,7184,-0.023580537151813064,13
13071,Tlahuiltepa,9753,4821,4932,-0.011381113503537373,13
13073,Tlanchinol,36382,17975,18407,-0.011874003628167776,13
13077,Tulancingo de Bravo,151584,71287,80297,-0.059438990922524804,13
13078,Xochiatipan,19067,9364,9703,-0.017779409450883726,13
13079,Xochicoatlán,7320,3618,3702,-0.011475409836065573,13
13080,Yahualica,23607,11574,12033,-0.019443385436523065,13
13081,Zacualtipán de Ángeles,32437,15416,17021,-0.0494805314918149,13
13084,Zimapán,38516,17948,20568,-0.06802367847128465,13
13072,Tlanalapa,10248,4944,5304,-0.0351288056206089,13
13021,Emiliano Zapata,13357,6322,7035,-0.05338025005615033,13
13059,Tecozautla,35067,16658,18409,-0.04993298542789517,13
13020,Eloxochitlán,2800,1321,1479,-0.056428571428571425,13
13037,Metztitlán,21623,10255,11368,-0.05147296859825186,13
13029,Huichapan,44253,21176,23077,-0.042957539601834904,13
13061,Tepeapulco,51664,24741,26923,-0.04223443790647259,13
13083,Zempoala,39143,19069,20074,-0.025675088777048258,13
13069,Tizayuca,97461,48102,49359,-0.012897466678979284,13
13075,Tolcayuca,13228,6454,6774,-0.02419110976716057,13
13052,San Agustín Tlaxiaca,32057,15597,16460,-0.02692079732975637,13
13066,Villa de Tezontepec,11654,5732,5922,-0.01630341513643384,13
13041,Mixquiahuala de Juárez,42834,20483,22351,-0.04361021618340571,13
13067,Tezontepec de Aldama,48025,23622,24403,-0.016262363352420615,13
13070,Tlahuelilpan,17153,8401,8752,-0.02046289278843351,13
13074,Tlaxcoapan,26758,13076,13682,-0.02264743254353838,13
13044,Nopala de Villagrán,15666,7689,7977,-0.018383761011106857,13
13017,Chapantongo,12271,6044,6227,-0.014913210007334365,13
13063,Tepeji del Río de Ocampo,80612,39569,41043,-0.018285118840867365,13
13076,Tula de Allende,103919,50490,53429,-0.028281642433048818,13
13010,Atitalaquia,26904,13253,13651,-0.0147933392804044,13
13013,Atotonilco de Tula,31078,15193,15885,-0.02226655511937705,13
13064,Tepetitlán,9940,4830,5110,-0.028169014084507043,13
13009,El Arenal,17374,8267,9107,-0.048348106365834004,13
13019,Chilcuautla,17436,8491,8945,-0.026038082128928653,13
13023,Francisco I. Madero,33901,16202,17699,-0.044157989439839535,13
13048,Pachuca de Soto,267862,127236,140626,-0.04998842687652597,13
13050,Progreso de Obregón,22217,10536,11681,-0.051537111221136966,13
13054,San Salvador,32773,15794,16979,-0.036157812833735085,13
13082,Zapotlán de Juárez,18036,8678,9358,-0.03770237303171435,13
13065,Tetepango,11112,5465,5647,-0.016378689704823614,13
13005,Ajacuba,17055,8375,8680,-0.017883318674875404,13
29001,Amaxac de Guerrero,9875,4819,5056,-0.024,29
30025,Ayahualulco,25456,12693,12763,-0.002749842866121936,30
30055,Chalma,12626,6221,6405,-0.014573103120544908,30
30056,Chiconamel,6752,3276,3476,-0.02962085308056872,30
30104,Mecayapan,17333,8501,8832,-0.019096521086943978,30
30150,Tamalín,11211,5599,5612,-0.0011595754170011597,30
30151,Tamiahua,23588,11841,11747,0.003985077157876887,30
30193,Veracruz,552156,261537,290619,-0.05266989763762415,30
21003,Acatlán,33865,15545,18320,-0.08194300900634874,21
19026,Guadalupe,678006,336731,341275,-0.0067020055869712065,19
19031,Juárez,256970,129324,127646,0.006529945129781687,19
19041,Pesquería,20843,10737,10106,0.03027395288586096,19
19049,Santiago,40469,20341,20128,0.005263287948800316,19
19018,García,143668,72640,71028,0.011220313500570761,19
19048,Santa Catarina,268955,134388,134567,-0.0006655388447881615,19
19039,Monterrey,1135550,561656,573894,-0.010777156444013914,19
19019,San Pedro Garza García,122659,57622,65037,-0.06045214782445642,19
19010,Carmen,16092,8175,7917,0.01603281133482476,19
19021,Gral. Escobedo,357937,180332,177605,0.007618659149515138,19
19045,Salinas Victoria,32660,16800,15860,0.02878138395590937,19
19025,Gral. Zuazua,55213,27787,27426,0.006538315251842863,19
19006,Apodaca,523370,263374,259996,0.006454324856220265,19
19012,Ciénega de Flores,24526,12476,12050,0.017369322351789937,19
19047,Hidalgo,16604,8318,8286,0.001927246446639364,19
19001,Abasolo,2791,1406,1385,0.007524184879971337,19
19013,China,10864,5585,5279,0.02816642120765832,19
19020,Gral. Bravo,5527,2876,2651,0.04070924552198299,19
19003,Los Aldamas,1374,708,666,0.03056768558951965,19
19015,Dr. Coss,1716,889,827,0.03613053613053613,19
19051,Villaldama,4113,2073,2040,0.008023340627279359,19
19044,Sabinas Hidalgo,34671,17214,17457,-0.007008739292203859,19
19046,San Nicolás de los Garza,443273,219337,223936,-0.010375096159702937,19
19008,Bustamante,3773,1890,1883,0.0018552875695732839,19
19033,Linares,78669,39104,39565,-0.005859995678094294,19
19050,Vallecillo,1971,1065,906,0.0806697108066971,19
19043,Rayones,2628,1363,1265,0.03729071537290715,19
19042,Los Ramones,5359,2720,2639,0.015114760216458294,19
19040,Parás,1034,512,522,-0.009671179883945842,19
19038,Montemorelos,59113,29370,29743,-0.006309948742239439,19
19037,Mina,5447,2774,2673,0.01854231687167248,19
19036,Mier y Noriega,7095,3555,3540,0.0021141649048625794,19
19035,Melchor Ocampo,862,433,429,0.004640371229698376,19
19034,Marín,5488,2808,2680,0.023323615160349854,19
19032,Lampazos de Naranjo,5349,2700,2649,0.009534492428491307,19
19030,Iturbide,3558,1844,1714,0.03653738055087127,19
19029,Hualahuises,6914,3424,3490,-0.009545849002024877,19
19028,Higueras,1594,829,765,0.04015056461731493,19
19027,Los Herreras,2030,1001,1029,-0.013793103448275862,19
19024,Gral. Zaragoza,5942,3052,2890,0.027263547627061596,19
19023,Gral. Treviño,1277,626,651,-0.01957713390759593,19
19022,Gral. Terán,14437,7234,7203,0.0021472605111865347,19
19017,Galeana,39991,20237,19754,0.012077717486434448,19
19016,Dr. González,3345,1713,1632,0.0242152466367713,19
19014,Dr. Arroyo,35445,17849,17596,0.007137819156439554,19
19011,Cerralvo,7855,4049,3806,0.030935709739019733,19
19009,Cadereyta Jiménez,86445,43939,42506,0.016577014286540574,19
19007,Aramberri,15470,7869,7601,0.017323852617970266,19
19005,Anáhuac,18480,9219,9261,-0.0022727272727272726,19
19004,Allende,32593,16440,16153,0.008805571748534961,19
19002,Agualeguas,3443,1777,1666,0.03223932616903863,19
05035,Torreón,639629,312135,327494,-0.024012357163293096,05
05024,Parras,45401,23062,22339,0.015924759366533776,05
05017,Matamoros,107160,53353,53807,-0.00423665546845838,05
05038,Zaragoza,12702,6410,6292,0.009289875610140136,05
05037,Villa Unión,6289,3217,3072,0.023056129750357767,05
05036,Viesca,21319,10762,10557,0.009615835639570336,05
05034,Sierra Mojada,6375,3306,3069,0.0371764705882353,05
05033,San Pedro,102650,51393,51257,0.0013248904042864101,05
05032,San Juan de Sabinas,41649,20502,21147,-0.015486566304112943,05
05031,San Buenaventura,22149,11044,11105,-0.0027540746760576097,05
05030,Saltillo,725123,359366,365757,-0.008813677127880374,05
05029,Sacramento,2314,1175,1139,0.015557476231633534,05
05028,Sabinas,60847,30247,30600,-0.005801436389633014,05
05027,Ramos Arizpe,75461,38302,37159,0.01514689707266005,05
05026,Progreso,3473,1774,1699,0.021595162683558884,05
05025,Piedras Negras,152806,76404,76402,1.3088491289609047e-05,05
05023,Ocampo,10991,5652,5339,0.028477845509962695,05
05022,Nava,27928,14237,13691,0.019550272128329993,05
05021,Nadadores,6335,3186,3149,0.005840568271507498,05
05020,Múzquiz,66834,33465,33369,0.001436394649429931,05
05019,Morelos,8207,4095,4112,-0.002071402461313513,05
05018,Monclova,216206,107401,108805,-0.00649380683237283,05
05016,Lamadrid,1835,941,894,0.02561307901907357,05
05015,Juárez,1599,827,772,0.03439649781113196,05
05014,Jiménez,9935,5041,4894,0.014796175138399597,05
05013,Hidalgo,1852,955,897,0.03131749460043196,05
05012,Guerrero,2091,1115,976,0.06647537063605931,05
05011,General Cepeda,11682,6071,5611,0.039376819037835985,05
05010,Frontera,75215,37561,37654,-0.001236455494249817,05
05009,Francisco I. Madero,55676,27739,27937,-0.0035562899633594367,05
05008,Escobedo,2901,1475,1426,0.016890727335401586,05
05007,Cuatro Ciénegas,13013,6565,6448,0.008991008991008992,05
05006,Castaños,25892,12945,12947,-7.724393635099645e-05,05
05005,Candela,1808,939,869,0.03871681415929203,05
05004,Arteaga,22544,11540,11004,0.023775727466288147,05
05003,Allende,22675,11114,11561,-0.019713340683572216,05
05002,Acuña,136755,68350,68405,-0.0004021790793755256,05
05001,Abasolo,1070,531,539,-0.007476635514018692,05
28016,Hidalgo,23793,12203,11590,0.02576388013281217,28
28027,Nuevo Laredo,384033,191001,193032,-0.0052886080102491195,28
28012,González,43435,21554,21881,-0.007528490848394152,28
28041,Victoria,321953,157152,164801,-0.023758126186120335,28
28039,Tula,27572,13717,13855,-0.005005077614971711,28
28008,Casas,4423,2326,2097,0.05177481347501696,28
28019,Llera,17333,8783,8550,0.013442566203196215,28
28023,Méndez,4530,2359,2171,0.04150110375275938,28
28001,Abasolo,12070,6041,6029,0.0009942004971002485,28
28002,Aldama,29470,14857,14613,0.008279606379368849,28
28004,Antiguo Morelos,9003,4494,4509,-0.0016661112962345886,28
28005,Burgos,4589,2377,2212,0.03595554587056003,28
28010,Cruillas,2011,1023,988,0.0174042764793635,28
28018,Jiménez,8338,4183,4155,0.0033581194531062605,28
28028,Nuevo Morelos,3381,1753,1628,0.03697131026323573,28
28029,Ocampo,12962,6603,6359,0.018824255516124055,28
28037,Soto la Marina,24764,12664,12100,0.022774995961880148,28
28040,Valle Hermoso,63170,31061,32109,-0.016590153553902167,28
28020,Mainero,2579,1313,1266,0.018224117875145406,28
28015,Gustavo Díaz Ordaz,15775,7979,7796,0.011600633914421553,28
28017,Jaumave,15105,7605,7500,0.006951340615690168,28
28026,Miquihuana,3514,1850,1664,0.05293113261240751,28
28007,Camargo,14933,7567,7366,0.013460121877720485,28
28034,San Carlos,9331,4897,4434,0.049619547744078875,28
28036,San Nicolás,1031,535,496,0.037827352085354024,28
28042,Villagrán,6316,3276,3040,0.037365421152628246,28
28006,Bustamante,7636,3953,3683,0.03535882661079099,28
28031,Palmillas,1795,901,894,0.0038997214484679664,28
28035,San Fernando,57220,28800,28420,0.006641034603285564,28
28014,Guerrero,4477,2316,2161,0.03462139825776189,28
28024,Mier,4762,2350,2412,-0.013019739605207897,28
28038,Tampico,297554,142334,155220,-0.04330642505225942,28
28009,Ciudad Madero,197216,94384,102832,-0.042836281031964955,28
28003,Altamira,212001,105619,106382,-0.00359903962717157,28
28043,Xicoténcatl,22864,11444,11420,0.0010496850944716584,28
28011,Gómez Farías,8786,4507,4279,0.025950375597541542,28
28021,El Mante,115792,56501,59291,-0.024094928837916262,28
28013,Güémez,15659,8091,7568,0.03339932307299317,28
28030,Padilla,14020,7100,6920,0.012838801711840228,28
28022,Matamoros,489193,242234,246959,-0.009658764536696151,28
28032,Reynosa,608891,303853,305038,-0.001946161135572705,28
28033,Río Bravo,118259,59174,59085,0.0007525854269019695,28
28025,Miguel Alemán,27015,13467,13548,-0.0029983342587451417,28
31050,Mérida,830732,401340,429392,-0.03376780959442997,31
31041,Kanasín,78709,39102,39607,-0.0064160388265636715,31
31059,Progreso,53958,26925,27033,-0.002001556766373846,31
31011,Celestún,6831,3493,3338,0.02269067486458791,31
31021,Chichimilá,7952,3982,3970,0.0015090543259557343,31
31023,Chocholá,4530,2318,2212,0.023399558498896248,31
31069,Sotuta,8449,4336,4113,0.026393656053970885,31
31068,Sinanché,3126,1622,1504,0.037747920665387076,31
31067,Seyé,9276,4733,4543,0.020482966796032773,31
31066,Santa Elena,3833,1855,1978,-0.03208974693451604,31
31065,San Felipe,1839,956,883,0.03969548667754214,31
31064,Sanahcat,1619,813,806,0.004323656578134651,31
31063,Samahil,5008,2532,2476,0.011182108626198083,31
31062,Sacalum,4589,2368,2221,0.03203312268468076,31
31061,Río Lagartos,3438,1749,1689,0.017452006980802792,31
31060,Quintana Roo,942,470,472,-0.0021231422505307855,31
31058,Peto,24159,12025,12134,-0.0045117761496750695,31
31057,Panabá,7461,3718,3743,-0.003350757271143278,31
31056,Oxkutzcab,29325,13947,15378,-0.048797953964194375,31
31055,Opichén,6285,3201,3084,0.018615751789976133,31
31054,Muxupip,2755,1341,1414,-0.026497277676951,31
31053,Muna,12336,6061,6275,-0.017347600518806745,31
31051,Mocochá,3071,1548,1523,0.0081406707912732,31
31049,Mayapán,3269,1676,1593,0.025390027531355153,31
31048,Maxcanú,21704,10860,10844,0.0007371913011426465,31
31047,Maní,5250,2560,2690,-0.024761904761904763,31
31046,Mama,2888,1366,1522,-0.054016620498614956,31
31045,Kopomá,2449,1255,1194,0.02490812576561862,31
31044,Kinchil,6571,3301,3270,0.004717698980368285,31
31043,Kaua,2761,1419,1342,0.027888446215139442,31
31042,Kantunil,5502,2764,2738,0.004725554343874954,31
31040,Izamal,25980,12887,13093,-0.007929176289453426,31
31039,Ixil,3803,1946,1857,0.02340257691296345,31
31038,Hunucmá,30731,15330,15401,-0.002310370635514627,31
31037,Huhí,4841,2471,2370,0.020863457963230737,31
31035,Hoctún,5697,2816,2881,-0.011409513779182026,31
31034,Hocabá,6061,3033,3028,0.0008249463784853984,31
31032,Espita,15571,7928,7643,0.01830325605291889,31
31031,Dzoncauich,2772,1401,1371,0.010822510822510822,31
31030,Dzitás,3540,1813,1727,0.024293785310734464,31
31029,Dzilam González,5905,3027,2878,0.025232853513971212,31
31028,Dzilam de Bravo,2463,1262,1201,0.02476654486398701,31
31027,Dzidzantún,8133,4115,4018,0.011926718308127382,31
31026,Dzemul,3489,1777,1712,0.018629979936944683,31
31025,Dzán,4941,2399,2542,-0.028941509815826754,31
31024,Chumayel,3148,1552,1596,-0.01397712833545108,31
31022,Chikindzonot,4162,2103,2059,0.010571840461316675,31
31020,Chicxulub Pueblo,4113,2123,1990,0.03233649404327741,31
31019,Chemax,33490,16797,16693,0.003105404598387578,31
31018,Chapab,3035,1509,1526,-0.005601317957166392,31
31017,Chankom,4464,2276,2188,0.01971326164874552,31
31016,Chacsinkín,2818,1417,1401,0.0056777856635912,31
31106,Yobaín,2137,1103,1034,0.03228825456247075,31
31105,Yaxkukul,2868,1443,1425,0.006276150627615063,31
31104,Yaxcabá,14802,7646,7156,0.03310363464396703,31
31103,Xocchel,3236,1660,1576,0.02595797280593325,31
31102,Valladolid,74217,36624,37593,-0.013056307853995716,31
31101,Umán,50993,25443,25550,-0.002098327221383327,31
31100,Ucú,3469,1744,1725,0.005477082732776016,31
31099,Uayma,3782,1944,1838,0.028027498677948175,31
31098,Tzucacab,14011,7102,6909,0.013774891156948112,31
31097,Tunkás,3464,1774,1690,0.02424942263279446,31
31096,Tizimín,73138,36468,36670,-0.0027619021575651507,31
31095,Tixpéhual,5388,2660,2728,-0.012620638455827766,31
31094,Tixmehuac,4746,2411,2335,0.016013485040033713,31
31093,Tixkokob,17176,8500,8676,-0.010246856078248719,31
31092,Tixcacalcupul,6665,3362,3303,0.008852213053263315,31
31091,Tinum,11421,5788,5633,0.013571491112862271,31
31090,Timucuy,6833,3496,3337,0.02326942777696473,31
31089,Ticul,37685,18593,19092,-0.013241342709300783,31
31088,Teya,1977,972,1005,-0.01669195751138088,31
31087,Tetiz,4725,2313,2412,-0.02095238095238095,31
31086,Tepakán,2226,1141,1085,0.025157232704402517,31
31085,Temozón,14801,7494,7307,0.012634281467468414,31
31084,Temax,6817,3425,3392,0.004840839078773654,31
31083,Telchac Puerto,1726,906,820,0.04982618771726535,31
31082,Telchac Pueblo,3557,1803,1754,0.013775653640708463,31
31081,Tekom,3100,1553,1547,0.001935483870967742,31
31080,Tekit,9884,4965,4919,0.0046539862403885066,31
31079,Tekax,40547,19975,20572,-0.014723654031124375,31
31078,Tekantó,3683,1830,1853,-0.006244909041542221,31
31077,Tekal de Venegas,2606,1313,1293,0.007674597083653108,31
31076,Tecoh,16200,8160,8040,0.007407407407407408,31
31075,Teabo,6205,3071,3134,-0.010153102336825141,31
31074,Tahmek,3609,1841,1768,0.02022720975339429,31
31073,Tahdziú,4447,2281,2166,0.025860130425005623,31
31072,Suma,1876,946,930,0.008528784648187633,31
31071,Sudzal,1689,890,799,0.053878034339846066,31
31070,Sucilá,3930,1994,1936,0.014758269720101781,31
31014,Cuncunul,1595,815,780,0.0219435736677116,31
31013,Conkal,9143,4584,4559,0.0027343322760581866,31
31012,Cenotillo,3701,1765,1936,-0.046203728721967034,31
31010,Cantamayec,2407,1255,1152,0.04279185708350644,31
31009,Cansahcab,4696,2327,2369,-0.008943781942078365,31
31008,Calotmul,4095,2080,2015,0.015873015873015872,31
31007,Cacalchén,6811,3483,3328,0.02275730436059316,31
31006,Buctzotz,8637,4336,4301,0.004052332985990506,31
31005,Bokobá,2053,1053,1000,0.025815879201169022,31
31004,Baca,5701,2819,2882,-0.011050692860901596,31
31003,Akil,10362,5104,5258,-0.014861995753715499,31
31002,Acanceh,15337,7599,7738,-0.00906305014018387,31
31001,Abalá,6356,3254,3102,0.02391441157960982,31
31033,Halachó,19072,9609,9463,0.007655201342281879,31
31036,Homún,7257,3688,3569,0.016397960589775388,31
31015,Cuzamá,4966,2493,2473,0.004027386226339106,31
31052,Motul,33978,16817,17161,-0.010124198010477368,31
04007,Palizada,8352,4230,4122,0.01293103448275862,04
04003,Carmen,221094,110317,110777,-0.0020805630184446435,04
04001,Calkiní,52890,26072,26818,-0.014104745698619777,04
04005,Hecelchakán,28306,14093,14213,-0.004239383876209991,04
04002,Campeche,259005,125561,133444,-0.03043570587440397,04
04011,Candelaria,41194,20924,20270,0.015876098460940912,04
04010,Calakmul,26882,13647,13235,0.015326240607097686,04
04009,Escárcega,54184,26809,27375,-0.010445888085043556,04
04008,Tenabo,9736,5002,4734,0.02752670501232539,04
04006,Hopelchén,37777,19306,18471,0.02210339624639331,04
04004,Champotón,83021,41760,41261,0.006010527456908493,04
23004,Othón P. Blanco,244553,121906,122647,-0.0030300180329008437,23
23005,Benito Juárez,661176,334945,326231,0.01317954674700836,23
23006,José María Morelos,36179,18506,17673,0.02302440642361591,23
23008,Solidaridad,159310,83468,75842,0.04786893478124411,23
23009,Tulum,28263,14714,13549,0.04121996957152461,23
23002,Felipe Carrillo Puerto,75026,37994,37032,0.01282222162983499,23
23001,Cozumel,79535,40357,39178,0.014823662538505061,23
23007,Lázaro Cárdenas,25333,12972,12361,0.02411873840445269,23
23003,Isla Mujeres,16203,8358,7845,0.03166080355489724,23
